airdrop_name,positive,neutral,negative,total,positive_percentage,neutral_percentage,negative_percentage
Zaros,14,19,1,34,41.17647058823529,55.88235294117647,2.941176470588235
Avarik Saga,2,0,0,2,100.0,0.0,0.0
Rainbow,23,17,3,43,53.48837209302325,39.53488372093023,6.976744186046512
Forma,1207,667,539,2413,50.02072109407377,27.641939494405303,22.33733941152093
Hyperliquid,13,0,2,15,86.66666666666667,0.0,13.333333333333334
Onchain,57,12,16,85,67.05882352941175,14.117647058823527,18.823529411764707
Syrup,5,3,9,17,29.411764705882355,17.647058823529413,52.94117647058824
Ithaca Protocol,1,2,0,3,33.33333333333333,66.66666666666666,0.0
Equation,31,31,12,74,41.891891891891895,41.891891891891895,16.216216216216218
Nekodex,13,1,0,14,92.85714285714286,7.142857142857142,0.0
Taiko,11,2,0,13,84.61538461538461,15.384615384615383,0.0
Fantasy Top,40,17,4,61,65.57377049180327,27.86885245901639,6.557377049180328
Anzen,0,1,0,1,0.0,100.0,0.0
Eigenpie,3,0,0,3,100.0,0.0,0.0
Oasis AI,20,0,1,21,95.23809523809524,0.0,4.761904761904762
Nexo,26,13,12,51,50.98039215686274,25.49019607843137,23.52941176470588
Pencils Protocol,0,2,0,2,0.0,100.0,0.0
Plume Network,16,24,3,43,37.2093023255814,55.81395348837209,6.976744186046512
Cryptopia,20,7,36,63,31.746031746031743,11.11111111111111,57.14285714285714
Iskra,8,4,1,13,61.53846153846154,30.76923076923077,7.6923076923076925
Lingo,18,108,6,132,13.636363636363637,81.81818181818183,4.545454545454546
Initia,425,259,206,890,47.752808988764045,29.10112359550562,23.146067415730336
Token Metrics,4,4,0,8,50.0,50.0,0.0
Gamium,24,3,1,28,85.71428571428571,10.714285714285714,3.571428571428571
Agora,21,9,8,38,55.26315789473685,23.684210526315788,21.052631578947366
Liquidium,1,1,0,2,50.0,50.0,0.0
Infinex,7,3,2,12,58.333333333333336,25.0,16.666666666666664
EtherMail,2,0,0,2,100.0,0.0,0.0
Vooi,1,1,0,2,50.0,50.0,0.0
Lyra,16,1,3,20,80.0,5.0,15.0
tea,3736,1208,1121,6065,61.599340478153344,19.917559769167354,18.48309975267931
M2,57,26,37,120,47.5,21.666666666666668,30.833333333333336
EYWA,17,6,13,36,47.22222222222222,16.666666666666664,36.11111111111111
deBridge,4,1,2,7,57.14285714285714,14.285714285714285,28.57142857142857
Delabs Games,12,0,0,12,100.0,0.0,0.0
ThetaNuts Finance,1,0,0,1,100.0,0.0,0.0
World PvP,24,5,13,42,57.14285714285714,11.904761904761903,30.952380952380956
Thruster,2,0,0,2,100.0,0.0,0.0
Rabby Wallet,17,5,17,39,43.58974358974359,12.82051282051282,43.58974358974359
Tari,155,114,83,352,44.034090909090914,32.38636363636363,23.579545454545457
Imaginary Ones,76,7,1,84,90.47619047619048,8.333333333333332,1.1904761904761905
Glacier Network,3,0,0,3,100.0,0.0,0.0
Storm Trade,2,0,0,2,100.0,0.0,0.0
Phaver,1,0,0,1,100.0,0.0,0.0
EigenLayer,27,17,34,78,34.61538461538461,21.7948717948718,43.58974358974359
Elfin,5,1,0,6,83.33333333333334,16.666666666666664,0.0
Masa,20,9,1,30,66.66666666666666,30.0,3.333333333333333
SpaceCatch,2,0,0,2,100.0,0.0,0.0
Mande Network,5,0,2,7,71.42857142857143,0.0,28.57142857142857
Xtremeverse,11,56,10,77,14.285714285714285,72.72727272727273,12.987012987012983
Fyde,6,2,2,10,60.0,20.0,20.0
Ekubo,16,0,4,20,80.0,0.0,20.0
CAGA,2,0,0,2,100.0,0.0,0.0
Sanctum,51,16,7,74,68.91891891891892,21.62162162162162,9.45945945945946
zkPass,8,0,0,8,100.0,0.0,0.0
My Lovely Planet,2,2,3,7,28.57142857142857,28.57142857142857,42.85714285714285
Tabi,256,189,99,544,47.05882352941176,34.74264705882353,18.198529411764707
Mode,1050,679,873,2602,40.35357417371253,26.09531129900077,33.5511145272867
Particle Network,6,2,0,8,75.0,25.0,0.0
XSwap,1,2,0,3,33.33333333333333,66.66666666666666,0.0
ZeroLend,1,0,0,1,100.0,0.0,0.0
Aperture Finance,10,24,2,36,27.77777777777778,66.66666666666666,5.555555555555555
Primex,34,12,58,104,32.69230769230769,11.538461538461538,55.76923076923077
MYTH,179,23,27,229,78.16593886462883,10.04366812227074,11.790393013100436
Immutable,52,184,12,248,20.967741935483872,74.19354838709677,4.838709677419355
Drift Protocol,3,0,1,4,75.0,0.0,25.0
Raiinmaker,15,0,1,16,93.75,0.0,6.25
Renzo,2,0,0,2,100.0,0.0,0.0
Blackwing,43,7,9,59,72.88135593220339,11.864406779661016,15.254237288135592
Kamino,5,0,0,5,100.0,0.0,0.0
Saltwater Games,1,0,0,1,100.0,0.0,0.0
UpRock,6,0,1,7,85.71428571428571,0.0,14.285714285714285
LunarStorm,0,1,1,2,0.0,50.0,50.0
Revolving Games,8,0,0,8,100.0,0.0,0.0
PlanetQuest,14,0,0,14,100.0,0.0,0.0
Zoth,17,6,5,28,60.71428571428571,21.428571428571427,17.857142857142858
BeFi Labs,2,0,0,2,100.0,0.0,0.0
Moongate,9,3,7,19,47.368421052631575,15.789473684210526,36.84210526315789
Sophon,1,0,0,1,100.0,0.0,0.0
Pixelverse,3,4,0,7,42.85714285714285,57.14285714285714,0.0
Apillon,1,0,0,1,100.0,0.0,0.0
Bemo,3,0,2,5,60.0,0.0,40.0
MilkyWay,13,2,6,21,61.90476190476191,9.523809523809524,28.57142857142857
Astaria,2,0,1,3,66.66666666666666,0.0,33.33333333333333
BSX,7,0,0,7,100.0,0.0,0.0
MANTRA,26,14,10,50,52.0,28.000000000000004,20.0
BounceBit,1,0,0,1,100.0,0.0,0.0
BlastOff,33,0,1,34,97.05882352941175,0.0,2.941176470588235
Soarchain,7,0,0,7,100.0,0.0,0.0
Elixir,42,6,3,51,82.35294117647058,11.76470588235294,5.88235294117647
Omni Network,13,0,0,13,100.0,0.0,0.0
Solv Protocol,7,6,1,14,50.0,42.85714285714285,7.142857142857142
Planet Mojo,32,1,0,33,96.96969696969695,3.0303030303030303,0.0
Parcl,3,2,2,7,42.85714285714285,28.57142857142857,28.57142857142857
DTX,31,8,5,44,70.45454545454545,18.181818181818183,11.363636363636363
Zeta,17,2,3,22,77.27272727272727,9.090909090909092,13.636363636363637
Juice,15,6,9,30,50.0,20.0,30.0
Karak,45,18,6,69,65.21739130434783,26.08695652173913,8.695652173913043
RedStone,7,3,1,11,63.63636363636363,27.27272727272727,9.090909090909092
Tensor,12,0,0,12,100.0,0.0,0.0
Pac Finance,4,0,0,4,100.0,0.0,0.0
OverTrip,6,7,6,19,31.57894736842105,36.84210526315789,31.57894736842105
Grass,23,18,27,68,33.82352941176471,26.47058823529412,39.70588235294117
Scallop,6,2,0,8,75.0,25.0,0.0
SynFutures,2,1,0,3,66.66666666666666,33.33333333333333,0.0
Orderly Network,1,0,0,1,100.0,0.0,0.0
Wormhole,14,17,10,41,34.14634146341464,41.46341463414634,24.390243902439025
Hava Coin,0,0,1,1,0.0,0.0,100.0
Ethena,35,10,13,58,60.3448275862069,17.24137931034483,22.41379310344828
Pryzm,37,9,31,77,48.05194805194805,11.688311688311687,40.25974025974026
COTI,26,39,11,76,34.21052631578947,51.31578947368421,14.473684210526317
A51,3,0,0,3,100.0,0.0,0.0
Sharpe,40,10,14,64,62.5,15.625,21.875
Elys Network,1,0,0,1,100.0,0.0,0.0
Haven1,13,0,0,13,100.0,0.0,0.0
Helix,25,15,8,48,52.083333333333336,31.25,16.666666666666664
Kelp DAO,20,6,0,26,76.92307692307693,23.07692307692308,0.0
mySwap,1,0,0,1,100.0,0.0,0.0
Braavos,0,1,0,1,0.0,100.0,0.0
BNB Chain,7,7,7,21,33.33333333333333,33.33333333333333,33.33333333333333
UniRouter,0,2,0,2,0.0,100.0,0.0
Aptos,21,6,7,34,61.76470588235294,17.647058823529413,20.588235294117645
beoble,3,0,0,3,100.0,0.0,0.0
Param Gaming,13,0,0,13,100.0,0.0,0.0
XYRO,15,2,15,32,46.875,6.25,46.875
Plena,1,0,0,1,100.0,0.0,0.0
Polyhedra Network,22,3,2,27,81.48148148148148,11.11111111111111,7.4074074074074066
DFlow,0,2,0,2,0.0,100.0,0.0
zkLend,4,1,0,5,80.0,20.0,0.0
Defispot,2,0,4,6,33.33333333333333,0.0,66.66666666666666
Cyber,80,24,51,155,51.61290322580645,15.483870967741936,32.903225806451616
Boson Protocol,14,1,0,15,93.33333333333331,6.666666666666667,0.0
Metis,11,2,0,13,84.61538461538461,15.384615384615383,0.0
DistrictOne,2,0,1,3,66.66666666666666,0.0,33.33333333333333
Layer3,1,1,1,3,33.33333333333333,33.33333333333333,33.33333333333333
Entangle,18,11,2,31,58.06451612903226,35.483870967741936,6.451612903225806
Panther Protocol,1,3,2,6,16.666666666666664,50.0,33.33333333333333
Memecoin,92,26,37,155,59.354838709677416,16.7741935483871,23.870967741935484
Teller,16,21,13,50,32.0,42.0,26.0
Parallel Network,10,4,2,16,62.5,25.0,12.5
Mocaverse,2,2,0,4,50.0,50.0,0.0
Venom,15,6,5,26,57.692307692307686,23.07692307692308,19.230769230769237
SYNTHR,2,0,0,2,100.0,0.0,0.0
Wen Exchange,13,0,0,13,100.0,0.0,0.0
YOLO Games,5,0,4,9,55.55555555555556,0.0,44.44444444444444
Lava,10,8,3,21,47.61904761904761,38.095238095238095,14.285714285714285
Blast,115,33,44,192,59.895833333333336,17.1875,22.916666666666664
InvArch,9,0,0,9,100.0,0.0,0.0
Avantis,40,10,3,53,75.47169811320755,18.867924528301888,5.660377358490567
Zircuit,1,0,0,1,100.0,0.0,0.0
Hana Network,5,1,1,7,71.42857142857143,14.285714285714285,14.285714285714285
MetaStreet,1,0,0,1,100.0,0.0,0.0
NuLink,3,0,0,3,100.0,0.0,0.0
Ambit Finance,7,1,3,11,63.63636363636363,9.090909090909092,27.27272727272727
Smart Layer,5,2,0,7,71.42857142857143,28.57142857142857,0.0
MON Protocol,13,0,0,13,100.0,0.0,0.0
Optimism,114,41,12,167,68.26347305389223,24.55089820359281,7.18562874251497
Blaster,5,6,10,21,23.809523809523807,28.57142857142857,47.61904761904761
StarkNet,41,9,2,52,78.84615384615384,17.307692307692307,3.8461538461538463
AltLayer,2,0,0,2,100.0,0.0,0.0
Pixels,12,2,17,31,38.70967741935484,6.451612903225806,54.83870967741935
AVNU,13,0,2,15,86.66666666666667,0.0,13.333333333333334
Bluefin,53,32,7,92,57.60869565217392,34.78260869565217,7.608695652173914
Overlay Protocol,55,54,10,119,46.21848739495798,45.37815126050421,8.403361344537815
ClayStack,0,1,0,1,0.0,100.0,0.0
Retro Bridge,1,0,0,1,100.0,0.0,0.0
Dymension,1,1,0,2,50.0,50.0,0.0
Pike,174,85,45,304,57.23684210526315,27.96052631578948,14.802631578947366
ZetaChain,11,2,0,13,84.61538461538461,15.384615384615383,0.0
Partisia Blockchain,2,0,0,2,100.0,0.0,0.0
Jupiter,6,5,0,11,54.54545454545454,45.45454545454545,0.0
Aether,9,0,3,12,75.0,0.0,25.0
Nostra,14,6,2,22,63.63636363636363,27.27272727272727,9.090909090909092
edeXa,1,0,0,1,100.0,0.0,0.0
Undeads,37,0,0,37,100.0,0.0,0.0
Aether Games,4,0,0,4,100.0,0.0,0.0
Dmail Network,4,0,0,4,100.0,0.0,0.0
Presearch,5,0,0,5,100.0,0.0,0.0
Bitcoin Virtual Machine,1,0,0,1,100.0,0.0,0.0
StackingDAO,4,5,1,10,40.0,50.0,10.0
NAVI Protocol,4,2,1,7,57.14285714285714,28.57142857142857,14.285714285714285
Mind Network,76,26,38,140,54.285714285714285,18.571428571428573,27.142857142857142
XION,115,18,0,133,86.46616541353383,13.533834586466163,0.0
Ready To Fight,7,2,2,11,63.63636363636363,18.181818181818183,18.181818181818183
Web3Go,1,0,0,1,100.0,0.0,0.0
Berachain,3,0,0,3,100.0,0.0,0.0
Synonym,2,4,7,13,15.384615384615383,30.76923076923077,53.84615384615385
eesee,1,0,0,1,100.0,0.0,0.0
Manta Network,6,0,0,6,100.0,0.0,0.0
Reveel,9,1,6,16,56.25,6.25,37.5
CARV,42,6,8,56,75.0,10.714285714285714,14.285714285714285
Swell,28,24,6,58,48.27586206896552,41.37931034482759,10.344827586206897
Frame,170,114,53,337,50.44510385756677,33.82789317507419,15.727002967359049
TeleportDAO,3,1,2,6,50.0,16.666666666666664,33.33333333333333
BRC20,8,4,5,17,47.05882352941176,23.52941176470588,29.411764705882355
Kinza Finance,0,0,4,4,0.0,0.0,100.0
Elusiv,28,11,4,43,65.11627906976744,25.58139534883721,9.30232558139535
Phoenix,108,48,34,190,56.84210526315789,25.26315789473684,17.894736842105264
Marinade,4,1,0,5,80.0,20.0,0.0
Jito,14,15,12,41,34.14634146341464,36.58536585365854,29.268292682926827
Term Structure,27,5,7,39,69.23076923076923,12.82051282051282,17.94871794871795
Affine,4,10,0,14,28.57142857142857,71.42857142857143,0.0
NovaDEX,5,0,3,8,62.5,0.0,37.5
Futureverse,2,0,0,2,100.0,0.0,0.0
Script Network,1,0,0,1,100.0,0.0,0.0
Patex,17,0,0,17,100.0,0.0,0.0
Pyth Network,6,0,0,6,100.0,0.0,0.0
Meuna,1,0,0,1,100.0,0.0,0.0
Satori,3,0,2,5,60.0,0.0,40.0
marginfi,1,0,0,1,100.0,0.0,0.0
Aori,101,39,17,157,64.3312101910828,24.840764331210192,10.828025477707008
GRVT,4,1,0,5,80.0,20.0,0.0
ShanHai,2,0,3,5,40.0,0.0,60.0
Tezos Domains,0,1,0,1,0.0,100.0,0.0
Celestia,23,6,18,47,48.93617021276596,12.76595744680851,38.297872340425535
Base,1834,993,637,3464,52.944572748267895,28.666281755196305,18.3891454965358
BlueLight,10,1,33,44,22.727272727272727,2.272727272727273,75.0
Verida,18,0,3,21,85.71428571428571,0.0,14.285714285714285
Xai,14,0,4,18,77.77777777777779,0.0,22.22222222222222
Omni,116,104,24,244,47.540983606557376,42.62295081967213,9.836065573770492
OKX,28,14,9,51,54.90196078431373,27.450980392156865,17.647058823529413
Mangrove,5,3,0,8,62.5,37.5,0.0
Altitude,2,0,1,3,66.66666666666666,0.0,33.33333333333333
Ambient,1,3,2,6,16.666666666666664,50.0,33.33333333333333
Connext,3,9,0,12,25.0,75.0,0.0
Clipper,19,9,10,38,50.0,23.684210526315788,26.31578947368421
Basilisk,17,7,7,31,54.83870967741935,22.58064516129032,22.58064516129032
Lightlink,43,0,2,45,95.55555555555556,0.0,4.444444444444445
Extra Finance,19,4,6,29,65.51724137931035,13.79310344827586,20.689655172413797
Hubble Exchange,2,0,0,2,100.0,0.0,0.0
HMX,45,8,1,54,83.33333333333334,14.814814814814811,1.851851851851852
MELD,86,10,1,97,88.65979381443299,10.309278350515465,1.0309278350515465
Worldcoin,8,3,16,27,29.629629629629623,11.11111111111111,59.25925925925925
DX25,8,0,0,8,100.0,0.0,0.0
Tsunami Finance,6,1,0,7,85.71428571428571,14.285714285714285,0.0
Archway,3,3,0,6,50.0,50.0,0.0
Polygon zkEVM,24,5,3,32,75.0,15.625,9.375
Diva,27,8,43,78,34.61538461538461,10.256410256410255,55.12820512820513
Vela Exchange,1,10,18,29,3.4482758620689653,34.48275862068966,62.06896551724138
Letit,8,0,0,8,100.0,0.0,0.0
WhiteBIT,17,5,10,32,53.125,15.625,31.25
Maverick Protocol,21,0,0,21,100.0,0.0,0.0
Velar,5,1,0,6,83.33333333333334,16.666666666666664,0.0
LunaFi,1,2,0,3,33.33333333333333,66.66666666666666,0.0
DBOE,0,4,0,4,0.0,100.0,0.0
Range Protocol,23,2,1,26,88.46153846153845,7.6923076923076925,3.8461538461538463
DigiFinex,8,4,0,12,66.66666666666666,33.33333333333333,0.0
BYDFi,3,0,2,5,60.0,0.0,40.0
Magic Square,12,1,0,13,92.3076923076923,7.6923076923076925,0.0
Foxify,5,0,0,5,100.0,0.0,0.0
PulseChain,22,16,6,44,50.0,36.36363636363637,13.636363636363637
DexCheck,22,0,1,23,95.65217391304348,0.0,4.3478260869565215
Rebel Bots,1,1,4,6,16.666666666666664,16.666666666666664,66.66666666666666
Hord,34,18,4,56,60.71428571428571,32.142857142857146,7.142857142857142
Cashmere,33,3,3,39,84.61538461538461,7.6923076923076925,7.6923076923076925
5ireChain,1,0,0,1,100.0,0.0,0.0
Yum Yum,58,3,3,64,90.625,4.6875,4.6875
ZKX,0,1,0,1,0.0,100.0,0.0
Increment,30,15,17,62,48.38709677419355,24.193548387096776,27.41935483870968
The Lost Wallet,47,36,19,102,46.07843137254902,35.294117647058826,18.62745098039216
Sui,334,195,171,700,47.71428571428572,27.857142857142858,24.428571428571427
Linea,53,42,41,136,38.97058823529412,30.88235294117647,30.14705882352941
SyncSwap,1,0,0,1,100.0,0.0,0.0
Huma Finance,1,0,0,1,100.0,0.0,0.0
SnowCone,7,0,0,7,100.0,0.0,0.0
Arbitrum,166,52,40,258,64.34108527131784,20.155038759689923,15.503875968992247
Quasar,2,0,0,2,100.0,0.0,0.0
Dune Analytics,12,1,0,13,92.3076923076923,7.6923076923076925,0.0
SPACE ID,15,0,2,17,88.23529411764706,0.0,11.76470588235294
Legends of Elysium,1,0,0,1,100.0,0.0,0.0
ZigZag,6,15,6,27,22.22222222222222,55.55555555555556,22.22222222222222
EZ Finance,1,0,0,1,100.0,0.0,0.0
Olive,29,14,10,53,54.71698113207547,26.41509433962264,18.867924528301888
Mayan,7,4,10,21,33.33333333333333,19.047619047619047,47.61904761904761
Sudoswap,6,6,1,13,46.15384615384615,46.15384615384615,7.6923076923076925
Timeless,35,8,17,60,58.333333333333336,13.333333333333334,28.33333333333333
BillionAir,90,37,32,159,56.60377358490566,23.270440251572328,20.12578616352201
SupraOracles,1,0,1,2,50.0,0.0,50.0
IPOR,12,2,0,14,85.71428571428571,14.285714285714285,0.0
Neptune Mutual,1,1,0,2,50.0,50.0,0.0
NFT3,2,0,0,2,100.0,0.0,0.0
Demex,10,5,4,19,52.63157894736842,26.31578947368421,21.052631578947366
Specular,8,5,2,15,53.333333333333336,33.33333333333333,13.333333333333334
Hashstack,1,0,0,1,100.0,0.0,0.0
Brine,11,1,6,18,61.11111111111112,5.555555555555555,33.33333333333333
V2X,34,4,0,38,89.47368421052632,10.526315789473683,0.0
Supernova,4,3,0,7,57.14285714285714,42.85714285714285,0.0
Bebop,13,9,5,27,48.14814814814815,33.33333333333333,18.51851851851852
KwikTrust,1,1,0,2,50.0,50.0,0.0
Phi,604,275,324,1203,50.20781379883624,22.8595178719867,26.93266832917705
Plenty,248,131,100,479,51.774530271398746,27.34864300626305,20.876826722338205
Swing,72,64,15,151,47.682119205298015,42.3841059602649,9.933774834437086
Spectrum Finance,9,25,0,34,26.47058823529412,73.52941176470588,0.0
Harbor Protocol,0,4,0,4,0.0,100.0,0.0
Sentiment,89,60,21,170,52.352941176470594,35.294117647058826,12.352941176470589
Vertex,3,2,0,5,60.0,40.0,0.0
Voltz,10,4,0,14,71.42857142857143,28.57142857142857,0.0
Uniswap,191,94,54,339,56.342182890855455,27.72861356932153,15.929203539823009
Across,331,190,114,635,52.1259842519685,29.92125984251969,17.95275590551181
Mean Finance,0,1,0,1,0.0,100.0,0.0
Key App,32,3,3,38,84.21052631578947,7.894736842105263,7.894736842105263
ParaSpace,8,0,0,8,100.0,0.0,0.0
Layerswap,8,2,0,10,80.0,20.0,0.0
Scroll,62,29,16,107,57.943925233644855,27.102803738317757,14.95327102803738
Aboard,6,3,3,12,50.0,25.0,25.0
MUN,1752,599,729,3080,56.88311688311688,19.448051948051948,23.66883116883117
Via Protocol,16,23,3,42,38.095238095238095,54.761904761904766,7.142857142857142
ChainHop,0,2,0,2,0.0,100.0,0.0
Cega,0,1,0,1,0.0,100.0,0.0
Wombat,17,10,3,30,56.66666666666666,33.33333333333333,10.0
MTG,48,142,22,212,22.641509433962263,66.98113207547169,10.37735849056604
Arrakis Finance,0,1,0,1,0.0,100.0,0.0
Dolomite,5,2,3,10,50.0,20.0,30.0
BlueMove,11,0,0,11,100.0,0.0,0.0
OptiFi,1,2,6,9,11.11111111111111,22.22222222222222,66.66666666666666
Sei,103,52,59,214,48.13084112149533,24.299065420560748,27.570093457943923
OpenChat,7,3,1,11,63.63636363636363,27.27272727272727,9.090909090909092
Shardeum,2,0,5,7,28.57142857142857,0.0,71.42857142857143
RabbitX,1,0,0,1,100.0,0.0,0.0
The Granary,17,1,8,26,65.38461538461539,3.8461538461538463,30.76923076923077
Metaplex,0,0,1,1,0.0,0.0,100.0
Tectum,0,0,2,2,0.0,0.0,100.0
Rage Trade,5,3,1,9,55.55555555555556,33.33333333333333,11.11111111111111
LayerZero,23,8,11,42,54.761904761904766,19.047619047619047,26.190476190476197
Pontem,8,1,0,9,88.88888888888889,11.11111111111111,0.0
Onomy Protocol,1,0,1,2,50.0,0.0,50.0
Blur,33,24,9,66,50.0,36.36363636363637,13.636363636363637
Trustless,55,44,41,140,39.285714285714285,31.428571428571427,29.28571428571429
Commodo,4,14,1,19,21.052631578947366,73.68421052631578,5.263157894736842
Stratos,6,12,0,18,33.33333333333333,66.66666666666666,0.0
Teritori,4,2,2,8,50.0,25.0,25.0
XEN Crypto,2,0,0,2,100.0,0.0,0.0
Helio Protocol,4,2,2,8,50.0,25.0,25.0
Karate Combat,16,2,10,28,57.14285714285714,7.142857142857142,35.714285714285715
Conic Finance,7,7,9,23,30.434782608695656,30.434782608695656,39.130434782608695
HTX,12,0,1,13,92.3076923076923,0.0,7.6923076923076925
Odos,2,2,0,4,50.0,50.0,0.0
KuCoin,162,38,36,236,68.64406779661016,16.101694915254235,15.254237288135592
Terran Coin,2,0,0,2,100.0,0.0,0.0
Quai Network,0,2,0,2,0.0,100.0,0.0
Dogechain,4,5,10,19,21.052631578947366,26.31578947368421,52.63157894736842
Portal,125,21,32,178,70.2247191011236,11.797752808988765,17.97752808988764
Cornerstone,30,12,8,50,60.0,24.0,16.0
Stride,32,10,2,44,72.72727272727273,22.727272727272727,4.545454545454546
Composable Finance,4,1,2,7,57.14285714285714,14.285714285714285,28.57142857142857
STRMNFT,2,0,0,2,100.0,0.0,0.0
Tegro,11,2,3,16,68.75,12.5,18.75
Quix,11,5,0,16,68.75,31.25,0.0
Bungee,3,0,1,4,75.0,0.0,25.0
StormGain,14,6,22,42,33.33333333333333,14.285714285714285,52.38095238095239
Tally Ho,2,0,0,2,100.0,0.0,0.0
Forta,129,40,62,231,55.84415584415584,17.316017316017316,26.83982683982684
Sweat Economy,8,3,3,14,57.14285714285714,21.428571428571427,21.428571428571427
ZORA,5,1,18,24,20.833333333333336,4.166666666666666,75.0
Velodrome,1,0,1,2,50.0,0.0,50.0
Chains,517,271,198,986,52.43407707910751,27.48478701825558,20.08113590263692
0VIX,0,0,2,2,0.0,0.0,100.0
Bonq,4,0,4,8,50.0,0.0,50.0
Epsylon,5,5,2,12,41.66666666666667,41.66666666666667,16.666666666666664
Ledn,8,2,1,11,72.72727272727273,18.181818181818183,9.090909090909092
RealMe,4,1,14,19,21.052631578947366,5.263157894736842,73.68421052631578
Matrix,46,9,23,78,58.97435897435898,11.538461538461538,29.48717948717949
Retrograde,2,0,0,2,100.0,0.0,0.0
Hop Protocol,1,0,0,1,100.0,0.0,0.0
Gem,527,214,220,961,54.83870967741935,22.2684703433923,22.892819979188346
Lend Flare,1,0,0,1,100.0,0.0,0.0
Armaldia,1,0,0,1,100.0,0.0,0.0
Leap Wallet,3,1,0,4,75.0,25.0,0.0
Fractional,25,18,5,48,52.083333333333336,37.5,10.416666666666668
Nebula Protocol,13,9,4,26,50.0,34.61538461538461,15.384615384615383
Orbofi,13,6,0,19,68.42105263157895,31.57894736842105,0.0
Styllar,7,2,0,9,77.77777777777779,22.22222222222222,0.0
Crescent Network,7,2,0,9,77.77777777777779,22.22222222222222,0.0
Tangible,38,30,12,80,47.5,37.5,15.0
Taki,1172,521,587,2280,51.40350877192983,22.850877192982452,25.745614035087723
ioTube,2,3,0,5,40.0,60.0,0.0
YoBit,6,1,12,19,31.57894736842105,5.263157894736842,63.1578947368421
Void Protocol,27,20,10,57,47.368421052631575,35.08771929824561,17.543859649122805
VINCI,60,8,48,116,51.72413793103448,6.896551724137931,41.37931034482759
cheqd,19,0,2,21,90.47619047619048,0.0,9.523809523809524
DAO Labs,2,0,0,2,100.0,0.0,0.0
Unagii,10,0,2,12,83.33333333333334,0.0,16.666666666666664
Nested,19,14,12,45,42.22222222222222,31.11111111111111,26.666666666666668
AssetMantle,2,2,2,6,33.33333333333333,33.33333333333333,33.33333333333333
Morpher,2,0,1,3,66.66666666666666,0.0,33.33333333333333
LimeWire,12,0,5,17,70.58823529411765,0.0,29.411764705882355
Mars Protocol,2,0,0,2,100.0,0.0,0.0
Findora,0,1,0,1,0.0,100.0,0.0
LikeCoin,1,0,0,1,100.0,0.0,0.0
Diffusion Finance,9,1,4,14,64.28571428571429,7.142857142857142,28.57142857142857
pSTAKE Finance,0,0,1,1,0.0,0.0,100.0
PartyBid,0,1,0,1,0.0,100.0,0.0
Frax,8,8,7,23,34.78260869565217,34.78260869565217,30.434782608695656
CowSwap,1,0,0,1,100.0,0.0,0.0
Orbiter Finance,15,10,2,27,55.55555555555556,37.03703703703704,7.4074074074074066
GameInfinity,35,0,0,35,100.0,0.0,0.0
Katana,32,6,3,41,78.04878048780488,14.634146341463412,7.317073170731707
Stargaze,14,1,2,17,82.35294117647058,5.88235294117647,11.76470588235294
Trust Domains,1,0,0,1,100.0,0.0,0.0
Fraktal,25,1,3,29,86.20689655172413,3.4482758620689653,10.344827586206897
Votium,9,0,0,9,100.0,0.0,0.0
Nomic,678,370,208,1256,53.98089171974523,29.458598726114648,16.560509554140125
Friktion,16,3,3,22,72.72727272727273,13.636363636363637,13.636363636363637
WhaleFin,9,4,6,19,47.368421052631575,21.052631578947366,31.57894736842105
Sonic,44,144,7,195,22.56410256410257,73.84615384615385,3.589743589743589
Quarry,9,0,0,9,100.0,0.0,0.0
OmniFlix,4,0,0,4,100.0,0.0,0.0
Shell Protocol,1,6,0,7,14.285714285714285,85.71428571428571,0.0
Mintbase,0,0,1,1,0.0,0.0,100.0
Legion Network,0,0,2,2,0.0,0.0,100.0
Rubicon,6,6,3,15,40.0,40.0,20.0
Glow,46,44,17,107,42.99065420560748,41.1214953271028,15.887850467289718
Coinhall,4,1,22,27,14.814814814814811,3.7037037037037033,81.48148148148148
LooksRare,2,2,2,6,33.33333333333333,33.33333333333333,33.33333333333333
StellarX,12,4,1,17,70.58823529411765,23.52941176470588,5.88235294117647
Coreum,11,2,2,15,73.33333333333333,13.333333333333334,13.333333333333334
Gas DAO,2,3,1,6,33.33333333333333,50.0,16.666666666666664
Astroport,9,4,1,14,64.28571428571429,28.57142857142857,7.142857142857142
Aztec,2,1,0,3,66.66666666666666,33.33333333333333,0.0
Terra Name Service,0,0,60,60,0.0,0.0,100.0
Lum Network,5,2,2,9,55.55555555555556,22.22222222222222,22.22222222222222
Francium,15,19,1,35,42.85714285714285,54.285714285714285,2.857142857142857
ICON,214,302,61,577,37.08838821490468,52.33968804159446,10.571923743500866
Paras,28,13,2,43,65.11627906976744,30.23255813953488,4.651162790697675
IOTA,249,74,180,503,49.50298210735586,14.7117296222664,35.785288270377734
Comdex,1,4,1,6,16.666666666666664,66.66666666666666,16.666666666666664
Volmex,3,0,0,3,100.0,0.0,0.0
iExec,13,0,1,14,92.85714285714286,0.0,7.142857142857142
Hangry Animals,9,0,0,9,100.0,0.0,0.0
Argent,43,56,24,123,34.959349593495936,45.52845528455284,19.51219512195122
Socean,1,0,0,1,100.0,0.0,0.0
Terra World,21,7,3,31,67.74193548387096,22.58064516129032,9.67741935483871
Superfluid,7,3,1,11,63.63636363636363,27.27272727272727,9.090909090909092
Hardcore FC,36,5,7,48,75.0,10.416666666666668,14.583333333333334
Sablier,1,31,0,32,3.125,96.875,0.0
Desmos,1,1,0,2,50.0,50.0,0.0
Atrix,46,9,23,78,58.97435897435898,11.538461538461538,29.48717948717949
TokenSets,4,32,0,36,11.11111111111111,88.88888888888889,0.0
Spintop,41,2,1,44,93.18181818181816,4.545454545454546,2.272727272727273
Phantom,12,15,3,30,40.0,50.0,10.0
DeBank,58,6,10,74,78.37837837837837,8.108108108108109,13.513513513513514
Aquarius,13,6,0,19,68.42105263157895,31.57894736842105,0.0
Saddle Finance,3,0,0,3,100.0,0.0,0.0
DexGuru,4,2,18,24,16.666666666666664,8.333333333333332,75.0
ParaSwap,13,3,1,17,76.47058823529412,17.647058823529413,5.88235294117647
Matcha,6,1,0,7,85.71428571428571,14.285714285714285,0.0
Solanart,9,2,0,11,81.81818181818183,18.181818181818183,0.0
Foundation,324,176,233,733,44.2019099590723,24.01091405184175,31.78717598908595
Digital Arms,32,2,6,40,80.0,5.0,15.0
Gridlock,10,1,9,20,50.0,5.0,45.0
Paladin,20,5,9,34,58.82352941176471,14.705882352941178,26.47058823529412
Apricot Finance,0,0,1,1,0.0,0.0,100.0
Sologenic,5,0,1,6,83.33333333333334,0.0,16.666666666666664
TerraFloki,3,0,0,3,100.0,0.0,0.0
DeFi Saver,0,1,0,1,0.0,100.0,0.0
OneOf,26,82,3,111,23.423423423423426,73.87387387387388,2.702702702702702
Zerion,3,6,6,15,20.0,40.0,40.0
BitYard,0,0,2,2,0.0,0.0,100.0
Zapper,11,33,3,47,23.404255319148938,70.2127659574468,6.382978723404255
HUMAN Protocol,13,0,1,14,92.85714285714286,0.0,7.142857142857142
Sportemon Go,17,2,9,28,60.71428571428571,7.142857142857142,32.142857142857146
Yield Protocol,0,0,2,2,0.0,0.0,100.0
Timeswap,2,2,0,4,50.0,50.0,0.0
Terra Land,6,14,0,20,30.0,70.0,0.0
Opyn,5,32,0,37,13.513513513513514,86.48648648648648,0.0
Symmetry,14,13,8,35,40.0,37.142857142857146,22.857142857142858
Apollo DAO,11,5,1,17,64.70588235294117,29.411764705882355,5.88235294117647
Solend,6,9,5,20,30.0,45.0,25.0
Terraswap,2,7,0,9,22.22222222222222,77.77777777777779,0.0
Talis Protocol,3,0,0,3,100.0,0.0,0.0
Flare Finance,9,6,2,17,52.94117647058824,35.294117647058826,11.76470588235294
Polymarket,5,0,3,8,62.5,0.0,37.5
zkSync,117,29,12,158,74.0506329113924,18.35443037974684,7.59493670886076
Valkyrie Protocol,37,6,3,46,80.43478260869566,13.043478260869565,6.521739130434782
Slingshot,17,8,8,33,51.51515151515152,24.24242424242424,24.24242424242424
OpenSea,39,21,18,78,50.0,26.923076923076923,23.07692307692308
Shade Protocol,6,12,0,18,33.33333333333333,66.66666666666666,0.0
Roco Finance,0,6,6,12,0.0,50.0,50.0
Backd,19,8,7,34,55.88235294117647,23.52941176470588,20.588235294117645
Loop,451,145,100,696,64.79885057471265,20.833333333333336,14.367816091954024
Metamask,96,39,44,179,53.63128491620112,21.787709497206706,24.581005586592177
Nexus Protocol,35,12,17,64,54.6875,18.75,26.5625
Boba Network,1,0,0,1,100.0,0.0,0.0
Portuma,3,0,1,4,75.0,0.0,25.0
BrightID,6,2,0,8,75.0,25.0,0.0
Adshares,5,0,0,5,100.0,0.0,0.0
Thales,37,3,0,40,92.5,7.5,0.0
Foil Network,2,0,0,2,100.0,0.0,0.0
Songbird,7,6,1,14,50.0,42.85714285714285,7.142857142857142
Tokel,1,0,0,1,100.0,0.0,0.0
Juno,75,15,5,95,78.94736842105263,15.789473684210526,5.263157894736842
Bitget,58,9,5,72,80.55555555555556,12.5,6.944444444444445
Remitano,3,2,1,6,50.0,33.33333333333333,16.666666666666664
StarTerra,9,6,2,17,52.94117647058824,35.294117647058826,11.76470588235294
Blockasset,32,8,10,50,64.0,16.0,20.0
SuperRare,3,1,3,7,42.85714285714285,14.285714285714285,42.85714285714285
Sunny,2,0,1,3,66.66666666666666,0.0,33.33333333333333
WEYU,6,0,4,10,60.0,0.0,40.0
dYdX,25,16,10,51,49.01960784313725,31.37254901960784,19.607843137254903
DFyn,0,1,0,1,0.0,100.0,0.0
Notional,0,0,2,2,0.0,0.0,100.0
Altair,8,9,2,19,42.10526315789473,47.368421052631575,10.526315789473683
EmiSwap,8,0,4,12,66.66666666666666,0.0,33.33333333333333
ShapeShift,44,16,23,83,53.01204819277109,19.27710843373494,27.710843373493976
THORSwap,7,0,4,11,63.63636363636363,0.0,36.36363636363637
OpenOcean,5,2,0,7,71.42857142857143,28.57142857142857,0.0
NFTb,8,1,1,10,80.0,10.0,10.0
hi,19283,6939,7338,33560,57.45828367103695,20.676400476758044,21.865315852205004
TAP,169,117,58,344,49.127906976744185,34.01162790697674,16.86046511627907
Moonbet,6,3,2,11,54.54545454545454,27.27272727272727,18.181818181818183
Connect Financial,6,4,0,10,60.0,40.0,0.0
Osmosis,67,26,5,98,68.36734693877551,26.53061224489796,5.1020408163265305
Pylon Protocol,29,7,12,48,60.41666666666666,14.583333333333334,25.0
GemBites,0,1,0,1,0.0,100.0,0.0
EarnBet,2,0,3,5,40.0,0.0,60.0
Orion Money,7,13,1,21,33.33333333333333,61.90476190476191,4.761904761904762
CRD Network,0,0,1,1,0.0,0.0,100.0
Instadapp,3,3,1,7,42.85714285714285,42.85714285714285,14.285714285714285
Blockster,4,0,0,4,100.0,0.0,0.0
Skyward Finance,1,0,0,1,100.0,0.0,0.0
MoonEdge,18,3,0,21,85.71428571428571,14.285714285714285,0.0
Thorstarter,4,0,0,4,100.0,0.0,0.0
Arweave,8,2,2,12,66.66666666666666,16.666666666666664,16.666666666666664
APENFT,1,0,4,5,20.0,0.0,80.0
EasyBake,2,0,4,6,33.33333333333333,0.0,66.66666666666666
Honeyswap,6,2,0,8,75.0,25.0,0.0
Charged Particles,6,4,9,19,31.57894736842105,21.052631578947366,47.368421052631575
Ribbon Finance,3,0,2,5,60.0,0.0,40.0
ZoidPay,1,0,0,1,100.0,0.0,0.0
QiSwap,2,2,0,4,50.0,50.0,0.0
DoRen,16,7,8,31,51.61290322580645,22.58064516129032,25.806451612903224
SolPAD,8,4,43,55,14.545454545454543,7.272727272727272,78.18181818181819
Convex Finance,3,0,0,3,100.0,0.0,0.0
RunNode,0,1,0,1,0.0,100.0,0.0
Venus,20,3,4,27,74.07407407407408,11.11111111111111,14.814814814814811
ChainX,1,0,0,1,100.0,0.0,0.0
Revuto,5,3,1,9,55.55555555555556,33.33333333333333,11.11111111111111
Solanium,5,2,4,11,45.45454545454545,18.181818181818183,36.36363636363637
Impermax Finance,2,2,0,4,50.0,50.0,0.0
Avalaunch,10,5,4,19,52.63157894736842,26.31578947368421,21.052631578947366
Etherlite,1,0,29,30,3.333333333333333,0.0,96.66666666666669
Badger DAO,1,1,2,4,25.0,25.0,50.0
Binance,428,106,112,646,66.25386996904025,16.408668730650156,17.3374613003096
DeversiFi,10,0,0,10,100.0,0.0,0.0
Bribe,20,2,3,25,80.0,8.0,12.0
SORA,13,0,16,29,44.82758620689656,0.0,55.172413793103445
Maiar Exchange,17,2,5,24,70.83333333333334,8.333333333333332,20.833333333333336
HOPR,3,0,0,3,100.0,0.0,0.0
Aladdin,4,2,0,6,66.66666666666666,33.33333333333333,0.0
KLOMP,6,0,0,6,100.0,0.0,0.0
LOTTO,16,6,18,40,40.0,15.0,45.0
1inch,10,7,9,26,38.46153846153847,26.923076923076923,34.61538461538461
UMA,715,312,267,1294,55.255023183925815,24.111282843894895,20.63369397217929
POAP,15,8,2,25,60.0,32.0,8.0
Secret Network,52,11,14,77,67.53246753246754,14.285714285714285,18.181818181818183
Hydra,24,2,1,27,88.88888888888889,7.4074074074074066,3.7037037037037033
Anchor Protocol,72,16,18,106,67.9245283018868,15.09433962264151,16.9811320754717
Graphene,3,0,0,3,100.0,0.0,0.0
Donnie Finance,0,0,1,1,0.0,0.0,100.0
Sperax,3,0,0,3,100.0,0.0,0.0
PoolTogether,4,3,17,24,16.666666666666664,12.5,70.83333333333334
Sifchain,15,4,3,22,68.18181818181817,18.181818181818183,13.636363636363637
Neutrino Protocol,6,0,1,7,85.71428571428571,0.0,14.285714285714285
Bounce,50,31,18,99,50.505050505050505,31.313131313131315,18.181818181818183
Furucombo,0,0,4,4,0.0,0.0,100.0
Lido,24,8,21,53,45.28301886792453,15.09433962264151,39.62264150943396
Chainge,10,2,0,12,83.33333333333334,16.666666666666664,0.0
OnX Finance,7,1,5,13,53.84615384615385,7.6923076923076925,38.46153846153847
Phala Network,1,0,0,1,100.0,0.0,0.0
Mirror Protocol,39,20,20,79,49.36708860759494,25.31645569620253,25.31645569620253
Numio,14,0,0,14,100.0,0.0,0.0
Flare,34,22,48,104,32.69230769230769,21.153846153846157,46.15384615384615
SocialGood,8,1,5,14,57.14285714285714,7.142857142857142,35.714285714285715
TomoChain,14,2,0,16,87.5,12.5,0.0
Audius,30,2,86,118,25.42372881355932,1.694915254237288,72.88135593220339
Plutus,29,23,21,73,39.72602739726028,31.506849315068493,28.767123287671232
DIA,1415,778,663,2856,49.54481792717087,27.240896358543417,23.214285714285715
Permission,126,38,70,234,53.84615384615385,16.23931623931624,29.914529914529915
Symbol,30,31,13,74,40.54054054054054,41.891891891891895,17.56756756756757
Bitcoin Rhodium,2,1,0,3,66.66666666666666,33.33333333333333,0.0
GoodDollar,12,31,6,49,24.489795918367346,63.26530612244898,12.244897959183673
ARCS,5,15,9,29,17.24137931034483,51.72413793103448,31.03448275862069
DeFiChain,21,4,5,30,70.0,13.333333333333334,16.666666666666664
Cypherium,28,1,0,29,96.55172413793105,3.4482758620689653,0.0
Handshake,1,2,0,3,33.33333333333333,66.66666666666666,0.0
Pcash,9,3,4,16,56.25,18.75,25.0
SwissBorg,16,4,0,20,80.0,20.0,0.0
UniWorld,6,0,0,6,100.0,0.0,0.0
BABB,10,5,7,22,45.45454545454545,22.727272727272727,31.818181818181817
Bitribe,4,0,0,4,100.0,0.0,0.0
DAO Maker,4,0,0,4,100.0,0.0,0.0
Escher,44,14,16,74,59.45945945945946,18.91891891891892,21.62162162162162
Bitbns,7,2,8,17,41.17647058823529,11.76470588235294,47.05882352941176
Ludena Protocol,6,3,6,15,40.0,20.0,40.0
PointPay,27,4,70,101,26.73267326732673,3.96039603960396,69.3069306930693
JUST,6030,2926,2879,11835,50.95057034220533,24.72327841149134,24.326151246303336
Relictum Pro,5,1,29,35,14.285714285714285,2.857142857142857,82.85714285714286
Storeum,4,3,1,8,50.0,37.5,12.5
Two Prime,33,14,8,55,60.0,25.454545454545453,14.545454545454543
PAC Global,0,0,4,4,0.0,0.0,100.0
Azbi,3,4,0,7,42.85714285714285,57.14285714285714,0.0
Storex,0,3,15,18,0.0,16.666666666666664,83.33333333333334
Blockpass,1,0,0,1,100.0,0.0,0.0
XinFin,18,1,0,19,94.73684210526316,5.263157894736842,0.0
1xBit,6,1,0,7,85.71428571428571,14.285714285714285,0.0
Swapzone,10,0,0,10,100.0,0.0,0.0
Tandem,48,9,7,64,75.0,14.0625,10.9375
JDX,14,9,7,30,46.66666666666666,30.0,23.33333333333333
Global Gaming,7,7,0,14,50.0,50.0,0.0
NokNok,5,2,0,7,71.42857142857143,28.57142857142857,0.0
Minereum,61,15,170,246,24.796747967479675,6.097560975609756,69.10569105691057
Unochain,3,0,0,3,100.0,0.0,0.0
KULAP,38,2,2,42,90.47619047619048,4.761904761904762,4.761904761904762
Petro,25,28,17,70,35.714285714285715,40.0,24.285714285714285
Personal Wager,16,2,4,22,72.72727272727273,9.090909090909092,18.181818181818183
Coalculus,1,0,0,1,100.0,0.0,0.0
Beldex,17,11,71,99,17.17171717171717,11.11111111111111,71.71717171717171
DAIN,4,0,0,4,100.0,0.0,0.0
Emirex,0,0,2,2,0.0,0.0,100.0
Bancor,13,9,16,38,34.21052631578947,23.684210526315788,42.10526315789473
ecxx,79,3,2,84,94.04761904761904,3.571428571428571,2.380952380952381
Pockero,2,0,0,2,100.0,0.0,0.0
Limestone Network,8,0,0,8,100.0,0.0,0.0
P2P Club,2,1,0,3,66.66666666666666,33.33333333333333,0.0
Lino Network,1,0,0,1,100.0,0.0,0.0
Brave New Coin,5,0,0,5,100.0,0.0,0.0
Riwigo,3,0,0,3,100.0,0.0,0.0
LiquidApps,4,0,0,4,100.0,0.0,0.0
HeroCoin,2,1,1,4,50.0,25.0,25.0
Morpheus Network,2,1,4,7,28.57142857142857,14.285714285714285,57.14285714285714
Stan World,24,11,16,51,47.05882352941176,21.568627450980397,31.37254901960784
Diagon,1,1,0,2,50.0,50.0,0.0
ReFork,2,0,0,2,100.0,0.0,0.0
Apollo,52,13,92,157,33.12101910828025,8.280254777070063,58.59872611464968
Cryptocells,2,2,0,4,50.0,50.0,0.0
Freelanex,6,0,0,6,100.0,0.0,0.0
2Key,21,0,7,28,75.0,0.0,25.0
TroyTrade,3,0,0,3,100.0,0.0,0.0
Kuvacash,28,6,18,52,53.84615384615385,11.538461538461538,34.61538461538461
ENOD,1,0,6,7,14.285714285714285,0.0,85.71428571428571
CUDOS,7,0,3,10,70.0,0.0,30.0
Yezcoin,1,0,0,1,100.0,0.0,0.0
Validity,11,3,2,16,68.75,18.75,12.5
RIF,796,378,378,1552,51.28865979381443,24.355670103092784,24.355670103092784
MediLiVes,10,0,0,10,100.0,0.0,0.0
Ormeus Ecosystem,1,0,0,1,100.0,0.0,0.0
INMINING,35,1,1,37,94.5945945945946,2.702702702702702,2.702702702702702
Maecenas,1,0,0,1,100.0,0.0,0.0
Nova Mining,2,0,0,2,100.0,0.0,0.0
Project WITH,404,32,32,468,86.32478632478633,6.837606837606838,6.837606837606838
Hydro,45,20,18,83,54.21686746987952,24.09638554216868,21.686746987951807
Pynk,28,15,2,45,62.22222222222222,33.33333333333333,4.444444444444445
GCOX,2,0,1,3,66.66666666666666,0.0,33.33333333333333
Cocos BCX,16,0,0,16,100.0,0.0,0.0
Livetree,5,1,1,7,71.42857142857143,14.285714285714285,14.285714285714285
Felixo,0,0,49,49,0.0,0.0,100.0
WINk,12,2,3,17,70.58823529411765,11.76470588235294,17.647058823529413
TeleCoin,1,0,21,22,4.545454545454546,0.0,95.45454545454544
Ellcrys,8,6,9,23,34.78260869565217,26.08695652173913,39.130434782608695
Bitpanda,15,4,0,19,78.94736842105263,21.052631578947366,0.0
Arena Match,3,0,0,3,100.0,0.0,0.0
Discodery,16,0,0,16,100.0,0.0,0.0
Qtum,8,2,0,10,80.0,20.0,0.0
Netkoin,0,1,0,1,0.0,100.0,0.0
Algorand,240,74,37,351,68.37606837606837,21.082621082621085,10.541310541310542
Ten Billion Coin,4,1,2,7,57.14285714285714,14.285714285714285,28.57142857142857
OVR,5,2,2,9,55.55555555555556,22.22222222222222,22.22222222222222
AllForCrypto,4,0,0,4,100.0,0.0,0.0
Civic,43,13,16,72,59.72222222222222,18.055555555555557,22.22222222222222
Komodo,26,6,16,48,54.16666666666666,12.5,33.33333333333333
BRIKCOIN,5,0,0,5,100.0,0.0,0.0
ParamountDax,2,0,0,2,100.0,0.0,0.0
Mediacoin,1,0,0,1,100.0,0.0,0.0
Dusk Network,6,5,1,12,50.0,41.66666666666667,8.333333333333332
FIO Social,1,0,0,1,100.0,0.0,0.0
COINCOME,1,1,2,4,25.0,25.0,50.0
Genesis,33,14,29,76,43.42105263157895,18.421052631578945,38.15789473684211
DocTailor,25,0,0,25,100.0,0.0,0.0
Fortem Capital,9,0,0,9,100.0,0.0,0.0
Authoreon,0,0,1,1,0.0,0.0,100.0
IdeaFeX,2,1,1,4,50.0,25.0,25.0
Typerium,3,0,0,3,100.0,0.0,0.0
VCC Exchange,1,14,0,15,6.666666666666667,93.33333333333331,0.0
ETHplode,32,10,36,78,41.02564102564102,12.82051282051282,46.15384615384615
SDAT,1,2,0,3,33.33333333333333,66.66666666666666,0.0
Sparrow,16,0,3,19,84.21052631578947,0.0,15.789473684210526
Anchor,122,60,35,217,56.22119815668203,27.64976958525346,16.129032258064516
CINDX,6,0,7,13,46.15384615384615,0.0,53.84615384615385
Atlas Protocol,18,2,3,23,78.26086956521739,8.695652173913043,13.043478260869565
PlasmaPay,10,1,1,12,83.33333333333334,8.333333333333332,8.333333333333332
Raven Protocol,19,4,1,24,79.16666666666666,16.666666666666664,4.166666666666666
Bcnex,14,3,1,18,77.77777777777779,16.666666666666664,5.555555555555555
Triffic,6,0,0,6,100.0,0.0,0.0
CoTrader,7,0,0,7,100.0,0.0,0.0
MimbleWimbleCoin,4,8,0,12,33.33333333333333,66.66666666666666,0.0
MiMiDi,0,2,0,2,0.0,100.0,0.0
Globatalent,1,0,0,1,100.0,0.0,0.0
Homebloc,11,0,0,11,100.0,0.0,0.0
XR Web,25,10,0,35,71.42857142857143,28.57142857142857,0.0
SUKU,3,0,0,3,100.0,0.0,0.0
Ampleforth,18,31,26,75,24.0,41.333333333333336,34.66666666666667
Bitwings,21,1,0,22,95.45454545454544,4.545454545454546,0.0
UHIVE,18,3,0,21,85.71428571428571,14.285714285714285,0.0
Tryvium,7,0,0,7,100.0,0.0,0.0
AiBB,1,1,3,5,20.0,20.0,60.0
Crypto Market Ads,5,0,0,5,100.0,0.0,0.0
UniversalCoin,12,2,0,14,85.71428571428571,14.285714285714285,0.0
P2PS,17,1,0,18,94.44444444444444,5.555555555555555,0.0
Bank of Hodlers,9,0,1,10,90.0,0.0,10.0
Opiria,2,0,0,2,100.0,0.0,0.0
Kozjin,1,0,0,1,100.0,0.0,0.0
BULLEX,0,0,1,1,0.0,0.0,100.0
Fesschain,1,0,0,1,100.0,0.0,0.0
Dayta,12,0,0,12,100.0,0.0,0.0
Mindexcoin,2,9,0,11,18.181818181818183,81.81818181818183,0.0
GRAYLL,2,0,0,2,100.0,0.0,0.0
Ferrum Network,43,1,0,44,97.72727272727272,2.272727272727273,0.0
TEN,4509,1954,1846,8309,54.26645805752798,23.516668672523767,22.21687326994825
NOIA Network,3,3,0,6,50.0,50.0,0.0
Matrix AI Network,27,1,6,34,79.41176470588235,2.941176470588235,17.647058823529413
AMUSE,5,7,1,13,38.46153846153847,53.84615384615385,7.6923076923076925
MediConnect,2,0,0,2,100.0,0.0,0.0
BitTube,31,43,29,103,30.097087378640776,41.74757281553398,28.155339805825243
Authpaper,5,1,0,6,83.33333333333334,16.666666666666664,0.0
LocalCoin,0,0,1,1,0.0,0.0,100.0
StellarPay,14,0,0,14,100.0,0.0,0.0
IOTW,76,3,4,83,91.56626506024097,3.614457831325301,4.819277108433735
Cryptoxygen,3,0,0,3,100.0,0.0,0.0
CINEMADROM,3,0,0,3,100.0,0.0,0.0
Fusion Coin,16,5,5,26,61.53846153846154,19.230769230769237,19.230769230769237
CBNT,16,1,8,25,64.0,4.0,32.0
ODEM,2,5,2,9,22.22222222222222,55.55555555555556,22.22222222222222
EarthBi,3,0,0,3,100.0,0.0,0.0
Futurepia,2,0,0,2,100.0,0.0,0.0
RTREE,24,0,16,40,60.0,0.0,40.0
Streamex,1,7,0,8,12.5,87.5,0.0
BitForex,13,3,6,22,59.09090909090909,13.636363636363637,27.27272727272727
AMANPURI,7,0,0,7,100.0,0.0,0.0
Atomic Wallet,46,7,12,65,70.76923076923077,10.76923076923077,18.461538461538463
EVEN Foundation,4,2,0,6,66.66666666666666,33.33333333333333,0.0
Konstellation,1,0,0,1,100.0,0.0,0.0
Gemstra,12,0,0,12,100.0,0.0,0.0
AVXChange,13,4,0,17,76.47058823529412,23.52941176470588,0.0
Licht Project,14,0,5,19,73.68421052631578,0.0,26.31578947368421
Somesing,3,0,0,3,100.0,0.0,0.0
Vite,129,26,39,194,66.49484536082474,13.402061855670103,20.103092783505154
MADANA,19,2,0,21,90.47619047619048,9.523809523809524,0.0
Knowledge,443,199,185,827,53.5671100362757,24.06287787182588,22.370012091898428
Monarch,6,34,0,40,15.0,85.0,0.0
Ally Network,3,1,0,4,75.0,25.0,0.0
Terra Credit,3,0,0,3,100.0,0.0,0.0
Tangle,77,40,145,262,29.38931297709924,15.267175572519085,55.34351145038168
Vecap,9,0,0,9,100.0,0.0,0.0
FST Network,9,0,0,9,100.0,0.0,0.0
Vodi X,1,0,0,1,100.0,0.0,0.0
QuarkChain,45,1,1,47,95.74468085106383,2.127659574468085,2.127659574468085
Digitex,3,3,7,13,23.07692307692308,23.07692307692308,53.84615384615385
Omnity,1,0,0,1,100.0,0.0,0.0
QuiGig,7,0,5,12,58.333333333333336,0.0,41.66666666666667
BitValve,9,0,0,9,100.0,0.0,0.0
ARCC,20,3,7,30,66.66666666666666,10.0,23.33333333333333
Verity,0,2,4,6,0.0,33.33333333333333,66.66666666666666
Belacam,23,4,3,30,76.66666666666667,13.333333333333334,10.0
BlocPal,0,0,5,5,0.0,0.0,100.0
Mindsync,15,0,0,15,100.0,0.0,0.0
Velic,1,1,2,4,25.0,25.0,50.0
HighBank,3,0,0,3,100.0,0.0,0.0
FortFC,36,12,0,48,75.0,25.0,0.0
CurveBlock,6,0,0,6,100.0,0.0,0.0
Huddl,7,3,3,13,53.84615384615385,23.07692307692308,23.07692307692308
Moozicore,28,1,1,30,93.33333333333331,3.333333333333333,3.333333333333333
CryptoSoul,15,0,0,15,100.0,0.0,0.0
Saiterm,8,0,0,8,100.0,0.0,0.0
XCOYNZ,1,0,0,1,100.0,0.0,0.0
BtcEX,1,0,1,2,50.0,0.0,50.0
VANM,2,0,50,52,3.8461538461538463,0.0,96.15384615384616
HyperionX,2,0,0,2,100.0,0.0,0.0
Crypto Potential,6,4,3,13,46.15384615384615,30.76923076923077,23.07692307692308
TriipMiles,3,0,0,3,100.0,0.0,0.0
YellowTradingCoin,1,0,0,1,100.0,0.0,0.0
Bluenote,14,5,17,36,38.88888888888889,13.88888888888889,47.22222222222222
Cogmento,2,0,0,2,100.0,0.0,0.0
XPChain,5,0,0,5,100.0,0.0,0.0
TheVault,2,0,0,2,100.0,0.0,0.0
CoinTiger,3,1,32,36,8.333333333333332,2.7777777777777777,88.88888888888889
Global Cryptocurrency,7,5,5,17,41.17647058823529,29.411764705882355,29.411764705882355
WHIRL,11,1,4,16,68.75,6.25,25.0
BitTorrent,12,8,13,33,36.36363636363637,24.24242424242424,39.39393939393939
Hxro,5,0,0,5,100.0,0.0,0.0
DACC,5,4,1,10,50.0,40.0,10.0
Singh,4,3,5,12,33.33333333333333,25.0,41.66666666666667
POP Network,1,1,0,2,50.0,50.0,0.0
MESG,5,3,2,10,50.0,30.0,20.0
PROOF OF TOSS,1,0,0,1,100.0,0.0,0.0
TerraGreen,46,4,3,53,86.79245283018868,7.547169811320755,5.660377358490567
PaxPago,9,0,0,9,100.0,0.0,0.0
The Collective,31,6,7,44,70.45454545454545,13.636363636363637,15.909090909090908
LTO Network,21,6,7,34,61.76470588235294,17.647058823529413,20.588235294117645
Insights Network,12,2,2,16,75.0,12.5,12.5
Cloverdex,4,3,0,7,57.14285714285714,42.85714285714285,0.0
Volentix,40,0,0,40,100.0,0.0,0.0
Energi,3,1,0,4,75.0,25.0,0.0
Opu Labs,1,0,0,1,100.0,0.0,0.0
MyCryptoBank,0,0,1,1,0.0,0.0,100.0
Petchains,0,0,2,2,0.0,0.0,100.0
Paradise Token,9,0,9,18,50.0,0.0,50.0
Konkrete,4,0,1,5,80.0,0.0,20.0
KlickZie,2,1,0,3,66.66666666666666,33.33333333333333,0.0
TradePlace,7,0,0,7,100.0,0.0,0.0
HubrisOne,28,2,26,56,50.0,3.571428571428571,46.42857142857143
Sentivate,15,0,2,17,88.23529411764706,0.0,11.76470588235294
Bitcoin Confidential,4,0,0,4,100.0,0.0,0.0
Dragonglass,1,0,0,1,100.0,0.0,0.0
THORChain,14,6,19,39,35.8974358974359,15.384615384615383,48.71794871794872
Griffex,9,0,3,12,75.0,0.0,25.0
Accumulus Threat Shield,12,0,0,12,100.0,0.0,0.0
EARNET,1,1,0,2,50.0,50.0,0.0
MobileGo,3,0,0,3,100.0,0.0,0.0
DNN,14,3,3,20,70.0,15.0,15.0
Playgroundz,6,0,1,7,85.71428571428571,0.0,14.285714285714285
BitSong,3,0,0,3,100.0,0.0,0.0
Inmax,2,3,0,5,40.0,60.0,0.0
Levolution,1,1,0,2,50.0,50.0,0.0
Bethereum,46,0,2,48,95.83333333333334,0.0,4.166666666666666
GAMB,280,117,130,527,53.13092979127134,22.2011385199241,24.667931688804558
Ice Chain,27,4,0,31,87.09677419354838,12.903225806451612,0.0
Pareto Network,3,0,0,3,100.0,0.0,0.0
Solarex,4,0,0,4,100.0,0.0,0.0
Spectrum,60,60,9,129,46.51162790697674,46.51162790697674,6.976744186046512
Faba,8,1,1,10,80.0,10.0,10.0
VeganNation,4,1,0,5,80.0,20.0,0.0
Tokenville,6,1,1,8,75.0,12.5,12.5
Gooreo,1,0,0,1,100.0,0.0,0.0
PopulStay,9,0,0,9,100.0,0.0,0.0
Uris,166,67,27,260,63.84615384615384,25.769230769230766,10.384615384615383
Havven,13,41,20,74,17.56756756756757,55.4054054054054,27.027027027027028
CryptoBonusMiles,1,1,0,2,50.0,50.0,0.0
Jarvis,2,0,30,32,6.25,0.0,93.75
Cubego,1,0,1,2,50.0,0.0,50.0
Unification,7,4,0,11,63.63636363636363,36.36363636363637,0.0
Mind AI,14,8,4,26,53.84615384615385,30.76923076923077,15.384615384615383
GoDDEX,11,14,4,29,37.93103448275862,48.27586206896552,13.79310344827586
SpringRole,7,1,0,8,87.5,12.5,0.0
Securypto,5,0,0,5,100.0,0.0,0.0
Dolla,571,342,296,1209,47.22911497105046,28.287841191067,24.483043837882548
Tune Token,3,0,0,3,100.0,0.0,0.0
V SYSTEMS,2,0,0,2,100.0,0.0,0.0
Orbise,3,3,0,6,50.0,50.0,0.0
Phoneum,33,5,8,46,71.73913043478261,10.869565217391305,17.391304347826086
C2C,29,17,0,46,63.04347826086957,36.95652173913043,0.0
BitCanna,1,1,0,2,50.0,50.0,0.0
Smart Trade Coin,2,0,0,2,100.0,0.0,0.0
Wellmee,77,1,0,78,98.71794871794872,1.282051282051282,0.0
ZenSports,15,0,0,15,100.0,0.0,0.0
Raido,10,13,3,26,38.46153846153847,50.0,11.538461538461538
Biton,13,6,5,24,54.16666666666666,25.0,20.833333333333336
UniFox,34,0,0,34,100.0,0.0,0.0
One Solution,6,1,0,7,85.71428571428571,14.285714285714285,0.0
Trippki,6,11,0,17,35.294117647058826,64.70588235294117,0.0
Murmur,7,0,1,8,87.5,0.0,12.5
Rewards,507,229,119,855,59.29824561403508,26.783625730994157,13.91812865497076
THE 4TH PILLAR,7,12,0,19,36.84210526315789,63.1578947368421,0.0
SocialRemit,19,0,1,20,95.0,0.0,5.0
ALLIVE,11,1,0,12,91.66666666666666,8.333333333333332,0.0
Clear Foundation,10,7,64,81,12.34567901234568,8.641975308641975,79.01234567901234
Qobit,19,0,0,19,100.0,0.0,0.0
GAMO Protocol,2,0,0,2,100.0,0.0,0.0
Bitozz,2,0,0,2,100.0,0.0,0.0
ND Invest,98,61,48,207,47.34299516908212,29.468599033816425,23.18840579710145
GG International,0,0,1,1,0.0,0.0,100.0
VeryFile,29,0,0,29,100.0,0.0,0.0
TEMCO,3,7,8,18,16.666666666666664,38.88888888888889,44.44444444444444
Social Note,7,5,3,15,46.66666666666666,33.33333333333333,20.0
X Infinity,7,1,4,12,58.333333333333336,8.333333333333332,33.33333333333333
Fidelity House,5,0,0,5,100.0,0.0,0.0
Bitcademy,3,0,0,3,100.0,0.0,0.0
Platin,15,5,6,26,57.692307692307686,19.230769230769237,23.07692307692308
London Block Exchange,9,0,0,9,100.0,0.0,0.0
Athero,39,0,0,39,100.0,0.0,0.0
Lition,5,5,14,24,20.833333333333336,20.833333333333336,58.333333333333336
SciDex,10,0,0,10,100.0,0.0,0.0
Betform,10,2,0,12,83.33333333333334,16.666666666666664,0.0
Yanu,10,2,3,15,66.66666666666666,13.333333333333334,20.0
Little Phil,28,5,5,38,73.68421052631578,13.157894736842104,13.157894736842104
HARA,569,267,196,1032,55.13565891472868,25.87209302325581,18.992248062015506
Vreo,0,0,1,1,0.0,0.0,100.0
Depository Network,44,3,0,47,93.61702127659576,6.382978723404255,0.0
Platio,3,0,8,11,27.27272727272727,0.0,72.72727272727273
BCoin,18,9,5,32,56.25,28.125,15.625
Skrumble Network,1,0,0,1,100.0,0.0,0.0
EtherInc,1,0,0,1,100.0,0.0,0.0
MyOS,2,2,0,4,50.0,50.0,0.0
Consensus,249,149,112,510,48.8235294117647,29.215686274509807,21.96078431372549
Stox,22,0,0,22,100.0,0.0,0.0
Instant Sponsor,1,0,1,2,50.0,0.0,50.0
MinedBlock,2,0,0,2,100.0,0.0,0.0
LEXIT,58,70,22,150,38.66666666666666,46.66666666666666,14.666666666666666
AIVON,1,0,0,1,100.0,0.0,0.0
Archetypal Network,1,0,0,1,100.0,0.0,0.0
B21,14,4,0,18,77.77777777777779,22.22222222222222,0.0
Open Packaging Network,1,0,0,1,100.0,0.0,0.0
Bistox Exchange,17,0,0,17,100.0,0.0,0.0
Connecty,30,0,0,30,100.0,0.0,0.0
Hydro Protocol,0,0,5,5,0.0,0.0,100.0
SIRIN LABS,8,2,2,12,66.66666666666666,16.666666666666664,16.666666666666664
Get Achieve,2,1,0,3,66.66666666666666,33.33333333333333,0.0
Bright Network,13,0,1,14,92.85714285714286,0.0,7.142857142857142
Sentinel,181,83,37,301,60.13289036544851,27.57475083056478,12.29235880398671
Certified Diamond Coin,1,0,3,4,25.0,0.0,75.0
idealcoin,1,0,0,1,100.0,0.0,0.0
GOZO,6,0,0,6,100.0,0.0,0.0
Smart Refinery Technologies,61,1,0,62,98.38709677419357,1.6129032258064515,0.0
Javvy,7,5,0,12,58.333333333333336,41.66666666666667,0.0
STAYGE,3,0,0,3,100.0,0.0,0.0
Zulu Republic,2,0,2,4,50.0,0.0,50.0
Aelf,36,2,1,39,92.3076923076923,5.128205128205128,2.564102564102564
weBloc,33,1,37,71,46.478873239436616,1.4084507042253522,52.11267605633802
Superbloom,28,2,1,31,90.32258064516128,6.451612903225806,3.225806451612903
Rise,680,373,287,1340,50.74626865671642,27.83582089552239,21.417910447761194
Bionic,9,4,0,13,69.23076923076923,30.76923076923077,0.0
Renaissance Engineering,38,33,5,76,50.0,43.42105263157895,6.578947368421052
Cubiex,1,1,0,2,50.0,50.0,0.0
Qredit,58,1,1,60,96.66666666666669,1.6666666666666667,1.6666666666666667
DigitalBits,3,6,1,10,30.0,60.0,10.0
IUNO,2,0,0,2,100.0,0.0,0.0
eMusic,45,62,35,142,31.690140845070424,43.66197183098591,24.647887323943664
Restart Energy,2,0,0,2,100.0,0.0,0.0
Infinitus,13,16,1,30,43.333333333333336,53.333333333333336,3.333333333333333
Lampix,8,1,1,10,80.0,10.0,10.0
Magnetics,24,11,4,39,61.53846153846154,28.205128205128204,10.256410256410255
AORA,1,0,1,2,50.0,0.0,50.0
Sportsfix,2,0,0,2,100.0,0.0,0.0
Qlear Protocol,11,0,0,11,100.0,0.0,0.0
Coinbates,16,3,0,19,84.21052631578947,15.789473684210526,0.0
ONO,1195,600,364,2159,55.34969893469198,27.79064381658175,16.85965724872626
Triphop,31,6,10,47,65.95744680851064,12.76595744680851,21.27659574468085
Neironix,2,0,1,3,66.66666666666666,0.0,33.33333333333333
PowerChain,27,9,3,39,69.23076923076923,23.07692307692308,7.6923076923076925
Xenia,10,9,1,20,50.0,45.0,5.0
Your Data Safe,8,8,0,16,50.0,50.0,0.0
Pigzbe,15,6,0,21,71.42857142857143,28.57142857142857,0.0
Storiqa,12,1,0,13,92.3076923076923,7.6923076923076925,0.0
Centaure,7,0,0,7,100.0,0.0,0.0
Loopring,94,60,15,169,55.62130177514793,35.50295857988166,8.875739644970414
AI Crypto,1,0,0,1,100.0,0.0,0.0
Social Media Pay,5,1,8,14,35.714285714285715,7.142857142857142,57.14285714285714
ABBC foundation,1,0,0,1,100.0,0.0,0.0
REDi,1074,511,381,1966,54.62868769074263,25.99186164801628,19.379450661241098
FasTrader,6,0,0,6,100.0,0.0,0.0
TokenBacon,4,0,1,5,80.0,0.0,20.0
SUAPP,19,0,0,19,100.0,0.0,0.0
DISTRICTS,1,6,0,7,14.285714285714285,85.71428571428571,0.0
ECTA,128,83,47,258,49.6124031007752,32.17054263565892,18.21705426356589
Silent Notary,4,0,0,4,100.0,0.0,0.0
Centive,264,156,75,495,53.333333333333336,31.515151515151512,15.151515151515152
PingPaid,2,0,2,4,50.0,0.0,50.0
Becent,11,1,28,40,27.500000000000004,2.5,70.0
XTribe,8,1,1,10,80.0,10.0,10.0
INLOCK,30,8,0,38,78.94736842105263,21.052631578947366,0.0
Krypti,17,3,5,25,68.0,12.0,20.0
Borneo,5,0,0,5,100.0,0.0,0.0
Tatau,2,0,0,2,100.0,0.0,0.0
Aenco,15,1,0,16,93.75,6.25,0.0
CyberVein,5,2,1,8,62.5,25.0,12.5
Karatcoin,7,0,0,7,100.0,0.0,0.0
ArtPro,1,0,0,1,100.0,0.0,0.0
Penchant,17,13,0,30,56.66666666666666,43.333333333333336,0.0
Parkade,4,1,111,116,3.4482758620689653,0.8620689655172413,95.6896551724138
NonZero,7,3,5,15,46.66666666666666,20.0,33.33333333333333
Cardonio,1,0,0,1,100.0,0.0,0.0
Swachhcoin,9,0,0,9,100.0,0.0,0.0
Shopin,25,1,2,28,89.28571428571429,3.571428571428571,7.142857142857142
Blockkonnect,3,0,0,3,100.0,0.0,0.0
Vibeo,1,1,0,2,50.0,50.0,0.0
Masternode Invest,18,1,0,19,94.73684210526316,5.263157894736842,0.0
Topex,6,3,1,10,60.0,30.0,10.0
Berminal,1,0,0,1,100.0,0.0,0.0
Expanse,4,2,0,6,66.66666666666666,33.33333333333333,0.0
AURA,70,22,19,111,63.06306306306306,19.81981981981982,17.117117117117118
WMpro,3,0,0,3,100.0,0.0,0.0
Securix,28,3,4,35,80.0,8.571428571428571,11.428571428571429
UDAP,0,1,0,1,0.0,100.0,0.0
Olife,8,2,3,13,61.53846153846154,15.384615384615383,23.07692307692308
Curaizon,3,0,0,3,100.0,0.0,0.0
ODIN,87,60,27,174,50.0,34.48275862068966,15.517241379310343
RedCab,144,0,6,150,96.0,0.0,4.0
XMax,25,7,0,32,78.125,21.875,0.0
Scienceroot,1,0,0,1,100.0,0.0,0.0
Buying,655,250,282,1187,55.181128896377416,21.061499578770007,23.75737152485257
One Game,12,3,4,19,63.1578947368421,15.789473684210526,21.052631578947366
WOM Token,1,0,0,1,100.0,0.0,0.0
Caspian,1,0,0,1,100.0,0.0,0.0
Natmin Pure Escrow,3,3,0,6,50.0,50.0,0.0
Zwoop,116,8,9,133,87.21804511278195,6.015037593984962,6.7669172932330826
INDX Capital,2,0,0,2,100.0,0.0,0.0
Skynet,4,0,2,6,66.66666666666666,0.0,33.33333333333333
LoveBlock,6,8,2,16,37.5,50.0,12.5
TTC PROTOCOL,37,4,0,41,90.2439024390244,9.75609756097561,0.0
Bithereum,9,0,0,9,100.0,0.0,0.0
MOAC,33,0,2,35,94.28571428571428,0.0,5.714285714285714
Bitfam,4,4,0,8,50.0,50.0,0.0
Republia,0,0,1,1,0.0,0.0,100.0
iTrue,8,1,5,14,57.14285714285714,7.142857142857142,35.714285714285715
Beam,11,22,3,36,30.55555555555556,61.11111111111112,8.333333333333332
KiMex,2,0,0,2,100.0,0.0,0.0
Twogap,4,0,0,4,100.0,0.0,0.0
LATTICE80,10,4,0,14,71.42857142857143,28.57142857142857,0.0
BitMart,37,9,3,49,75.51020408163265,18.367346938775512,6.122448979591836
Efforce,9,2,4,15,60.0,13.333333333333334,26.666666666666668
Spiking,8,14,6,28,28.57142857142857,50.0,21.428571428571427
Bidooh,2,0,1,3,66.66666666666666,0.0,33.33333333333333
imusify,12,0,1,13,92.3076923076923,0.0,7.6923076923076925
ICOVO,4,0,0,4,100.0,0.0,0.0
Cloudbric,6,2,1,9,66.66666666666666,22.22222222222222,11.11111111111111
Tachain,17,2,0,19,89.47368421052632,10.526315789473683,0.0
Scanetchain,4,5,0,9,44.44444444444444,55.55555555555556,0.0
Payperblock,0,2,0,2,0.0,100.0,0.0
Greenlink,48,21,10,79,60.75949367088608,26.58227848101265,12.658227848101266
55 Exchange,10,4,2,16,62.5,25.0,12.5
Finnoq,1,1,0,2,50.0,50.0,0.0
Gosama,0,1,0,1,0.0,100.0,0.0
LaneAxis,2,0,0,2,100.0,0.0,0.0
CRYPTTO,13,5,0,18,72.22222222222221,27.77777777777778,0.0
NAU,101,21,29,151,66.88741721854305,13.90728476821192,19.205298013245034
TrigID,32,0,0,32,100.0,0.0,0.0
VeChain,89,6,14,109,81.65137614678899,5.504587155963304,12.844036697247708
Avatara,9,2,0,11,81.81818181818183,18.181818181818183,0.0
ODYSSEY,12,1,3,16,75.0,6.25,18.75
Rate3,1,2,0,3,33.33333333333333,66.66666666666666,0.0
Bouncy Coin,5,4,2,11,45.45454545454545,36.36363636363637,18.181818181818183
AgentMile,0,0,12,12,0.0,0.0,100.0
Hirefreehands,19,1,0,20,95.0,5.0,0.0
Denarii Cash,1,0,0,1,100.0,0.0,0.0
WebDollar,23,3,4,30,76.66666666666667,10.0,13.333333333333334
WeBuy,29,2,8,39,74.35897435897436,5.128205128205128,20.51282051282051
MECA Coin,1,1,0,2,50.0,50.0,0.0
AGATE,6,3,2,11,54.54545454545454,27.27272727272727,18.181818181818183
Kronos Token,6,0,0,6,100.0,0.0,0.0
Wandx,5,3,0,8,62.5,37.5,0.0
Envoy,0,2,1,3,0.0,66.66666666666666,33.33333333333333
Symphony,2,0,0,2,100.0,0.0,0.0
Margin,441,75,65,581,75.90361445783132,12.908777969018931,11.187607573149744
GSC Aviation,3,0,0,3,100.0,0.0,0.0
Share Internet Data,1,0,0,1,100.0,0.0,0.0
MetaHash,1,0,0,1,100.0,0.0,0.0
HyperQuant,4,1,0,5,80.0,20.0,0.0
Kheper,2,4,8,14,14.285714285714285,28.57142857142857,57.14285714285714
VIDDO,25,11,8,44,56.81818181818182,25.0,18.181818181818183
GreenHashes,7,0,4,11,63.63636363636363,0.0,36.36363636363637
Pearl Pay,5,5,2,12,41.66666666666667,41.66666666666667,16.666666666666664
High Performance Blockchain,19,3,7,29,65.51724137931035,10.344827586206897,24.13793103448276
Conference Coin,1,1,0,2,50.0,50.0,0.0
YondoCoin,3,0,0,3,100.0,0.0,0.0
Kvantor,2,1,0,3,66.66666666666666,33.33333333333333,0.0
Jupiter Chain,1,0,0,1,100.0,0.0,0.0
MARAChain,9,0,0,9,100.0,0.0,0.0
NextPakk,28,0,0,28,100.0,0.0,0.0
LockTrip,10,0,6,16,62.5,0.0,37.5
ZINC,3,2,0,5,60.0,40.0,0.0
SilkChain,6,0,0,6,100.0,0.0,0.0
CraftR,1,0,0,1,100.0,0.0,0.0
Hashgard,1,0,0,1,100.0,0.0,0.0
Contractium,24,0,0,24,100.0,0.0,0.0
MOBU,12,14,1,27,44.44444444444444,51.85185185185185,3.7037037037037033
Philanthor,11,2,0,13,84.61538461538461,15.384615384615383,0.0
Medipedia,0,1,0,1,0.0,100.0,0.0
Real Estate Doc,10,2,4,16,62.5,12.5,25.0
CAREONchain,2,0,0,2,100.0,0.0,0.0
Project H,314,24,26,364,86.26373626373626,6.593406593406594,7.142857142857142
OpenBrix,0,1,0,1,0.0,100.0,0.0
VU Token,14,1,0,15,93.33333333333331,6.666666666666667,0.0
CampusCoin,3,0,0,3,100.0,0.0,0.0
BlockVest,21,1,33,55,38.18181818181819,1.818181818181818,60.0
INTRO,618,243,182,1043,59.25215723873441,23.29817833173538,17.449664429530202
GStar Ecosystem,5,1,0,6,83.33333333333334,16.666666666666664,0.0
Everipedia,2,0,3,5,40.0,0.0,60.0
Vidy,2,0,0,2,100.0,0.0,0.0
SVPER,17,0,2,19,89.47368421052632,0.0,10.526315789473683
Tokenize,49,20,8,77,63.63636363636363,25.97402597402597,10.38961038961039
Dream Real,24,2,3,29,82.75862068965517,6.896551724137931,10.344827586206897
Asian Develop Coin,1,0,0,1,100.0,0.0,0.0
BLOXIA,5,0,0,5,100.0,0.0,0.0
Color,143,60,31,234,61.11111111111112,25.64102564102564,13.247863247863249
Watermelonblock,1,2,0,3,33.33333333333333,66.66666666666666,0.0
BIGBANG,26,4,12,42,61.90476190476191,9.523809523809524,28.57142857142857
Starflow,11,1,0,12,91.66666666666666,8.333333333333332,0.0
MYTC,2,0,0,2,100.0,0.0,0.0
Aniko,21,3,21,45,46.66666666666666,6.666666666666667,46.66666666666666
W Green Pay,7,4,0,11,63.63636363636363,36.36363636363637,0.0
GUARIUM,1,0,0,1,100.0,0.0,0.0
Propy,10,0,1,11,90.9090909090909,0.0,9.090909090909092
DNeT,4,0,0,4,100.0,0.0,0.0
Meritt protocol,6,0,0,6,100.0,0.0,0.0
MulTra,4,0,0,4,100.0,0.0,0.0
Expercoin,5,0,0,5,100.0,0.0,0.0
Kava,3,0,1,4,75.0,0.0,25.0
Bytemine,4,0,0,4,100.0,0.0,0.0
UNICO,26,11,10,47,55.319148936170215,23.404255319148938,21.27659574468085
Diro,5,1,0,6,83.33333333333334,16.666666666666664,0.0
Gratzio,11,1,3,15,73.33333333333333,6.666666666666667,20.0
Inmediate,1,0,0,1,100.0,0.0,0.0
JSEcoin,8,0,0,8,100.0,0.0,0.0
PCHAIN,33,3,12,48,68.75,6.25,25.0
Shipit,11,2,0,13,84.61538461538461,15.384615384615383,0.0
Miracle Tele,10,0,0,10,100.0,0.0,0.0
Runs,132,86,49,267,49.43820224719101,32.20973782771536,18.352059925093634
IGNITE,34,16,5,55,61.81818181818181,29.09090909090909,9.090909090909092
eLYQD,22,0,0,22,100.0,0.0,0.0
Bailsman,1,0,0,1,100.0,0.0,0.0
Lambda,37,13,11,61,60.65573770491803,21.311475409836063,18.0327868852459
Rubius,5,3,4,12,41.66666666666667,25.0,33.33333333333333
Svandis,13,0,0,13,100.0,0.0,0.0
Playrs,3,0,0,3,100.0,0.0,0.0
CoinAnalyst,4,0,0,4,100.0,0.0,0.0
Spokkz,54,1,0,55,98.1818181818182,1.818181818181818,0.0
Zantepay,14,1,0,15,93.33333333333331,6.666666666666667,0.0
Cure Cosplay,1,0,0,1,100.0,0.0,0.0
WAB Network,1,0,0,1,100.0,0.0,0.0
Liquid8,58,1,3,62,93.5483870967742,1.6129032258064515,4.838709677419355
Fanship,30,2,4,36,83.33333333333334,5.555555555555555,11.11111111111111
CrowdToken,1,0,0,1,100.0,0.0,0.0
OSA,232,119,98,449,51.67037861915368,26.50334075723831,21.826280623608017
moolyacoin,1,0,0,1,100.0,0.0,0.0
Hyperbridge,5,0,10,15,33.33333333333333,0.0,66.66666666666666
Usechain,6,0,0,6,100.0,0.0,0.0
ParcelX,2,0,0,2,100.0,0.0,0.0
APRES,43,8,6,57,75.43859649122807,14.035087719298245,10.526315789473683
Blockhive,3,0,0,3,100.0,0.0,0.0
Creatanium,7,0,0,7,100.0,0.0,0.0
Monopoly,35,29,15,79,44.303797468354425,36.70886075949368,18.9873417721519
Explorio,5,1,0,6,83.33333333333334,16.666666666666664,0.0
EPIPHANY,33,13,14,60,55.00000000000001,21.666666666666668,23.33333333333333
BUMO,2,0,0,2,100.0,0.0,0.0
Barrel,21,22,29,72,29.166666666666668,30.55555555555556,40.27777777777778
CryptoMillionsLotto,1,0,0,1,100.0,0.0,0.0
ImmVRse,1,0,0,1,100.0,0.0,0.0
Atidium,4,1,0,5,80.0,20.0,0.0
DTO,13,2,0,15,86.66666666666667,13.333333333333334,0.0
Provoco,0,1,0,1,0.0,100.0,0.0
TraXion,108,12,0,120,90.0,10.0,0.0
BitEsprit,18,1,0,19,94.73684210526316,5.263157894736842,0.0
Dench Music,1,0,0,1,100.0,0.0,0.0
Versara Trade,21,0,0,21,100.0,0.0,0.0
HelloGold,30,13,0,43,69.76744186046511,30.23255813953488,0.0
Waves,36,24,13,73,49.31506849315068,32.87671232876712,17.80821917808219
MEvU,58,7,1,66,87.87878787878788,10.606060606060606,1.5151515151515151
Casper API,15,1,0,16,93.75,6.25,0.0
WAR FIELD,19,9,5,33,57.57575757575758,27.27272727272727,15.151515151515152
Leonardian,2,2,0,4,50.0,50.0,0.0
Cornucopia,15,1,6,22,68.18181818181817,4.545454545454546,27.27272727272727
Tutellus,3,1,0,4,75.0,25.0,0.0
Corl,6,4,0,10,60.0,40.0,0.0
Prandex,1,0,0,1,100.0,0.0,0.0
Blockonomics,6,0,0,6,100.0,0.0,0.0
Nauticus,18,6,0,24,75.0,25.0,0.0
Further Network,23,5,20,48,47.91666666666667,10.416666666666668,41.66666666666667
Breezecoin,3,0,2,5,60.0,0.0,40.0
RAcoin,3,0,2,5,60.0,0.0,40.0
TRESARO,11,2,0,13,84.61538461538461,15.384615384615383,0.0
Wemark,16,2,2,20,80.0,10.0,10.0
ERN,2875,1642,1402,5919,48.57239398547052,27.741172495353943,23.686433519175537
Terawatt,24,16,9,49,48.97959183673469,32.6530612244898,18.367346938775512
Feedchain,3,0,0,3,100.0,0.0,0.0
Staramba,8,1,0,9,88.88888888888889,11.11111111111111,0.0
GreenX,7,0,5,12,58.333333333333336,0.0,41.66666666666667
FTW,338,188,146,672,50.29761904761904,27.97619047619048,21.72619047619048
Atlantis Blue,14,0,1,15,93.33333333333331,0.0,6.666666666666667
Parkres,4,1,0,5,80.0,20.0,0.0
0xcert,3,0,10,13,23.07692307692308,0.0,76.92307692307693
Humanscape,3,0,0,3,100.0,0.0,0.0
CrowdIF,9,0,0,9,100.0,0.0,0.0
VideoCoin,25,1,0,26,96.15384615384616,3.8461538461538463,0.0
Nebula,140,24,7,171,81.87134502923976,14.035087719298245,4.093567251461988
NeoNameService,21,10,4,35,60.0,28.57142857142857,11.428571428571429
Sparkster,28,5,4,37,75.67567567567568,13.513513513513514,10.81081081081081
Buddy,65,18,25,108,60.18518518518518,16.666666666666664,23.14814814814815
CrypStock,6,0,0,6,100.0,0.0,0.0
Luvdub,28,0,1,29,96.55172413793105,0.0,3.4482758620689653
Aworker,2,8,13,23,8.695652173913043,34.78260869565217,56.52173913043478
QLC Chain,32,9,4,45,71.11111111111111,20.0,8.88888888888889
Sponsy,3,0,0,3,100.0,0.0,0.0
InsCoin,27,0,0,27,100.0,0.0,0.0
ExTrade,0,0,2,2,0.0,0.0,100.0
MUXE,3,0,0,3,100.0,0.0,0.0
Lina,42,19,9,70,60.0,27.142857142857142,12.857142857142856
Origin Sport,8,0,0,8,100.0,0.0,0.0
Railz,0,8,0,8,0.0,100.0,0.0
ContentBox,63,0,3,66,95.45454545454544,0.0,4.545454545454546
rLoop,4,1,2,7,57.14285714285714,14.285714285714285,28.57142857142857
Bitney,22,1,4,27,81.48148148148148,3.7037037037037033,14.814814814814811
APIS,87,47,43,177,49.15254237288136,26.55367231638418,24.293785310734464
IndiCoin,21,0,0,21,100.0,0.0,0.0
Nobar,1,1,0,2,50.0,50.0,0.0
Coinself,3,0,0,3,100.0,0.0,0.0
Deedcoin,2,0,0,2,100.0,0.0,0.0
DAV,123,42,26,191,64.3979057591623,21.98952879581152,13.612565445026178
INGOT Coin,27,4,0,31,87.09677419354838,12.903225806451612,0.0
Profede,12,0,0,12,100.0,0.0,0.0
GlobeCas,1,0,1,2,50.0,0.0,50.0
GOeureka,2,0,0,2,100.0,0.0,0.0
Xeeda,3,1,0,4,75.0,25.0,0.0
Jibbit,7,2,0,9,77.77777777777779,22.22222222222222,0.0
Loyakk,2,0,0,2,100.0,0.0,0.0
AVINOC,16,0,0,16,100.0,0.0,0.0
TokenUnion,2,0,0,2,100.0,0.0,0.0
Root Blockchain,3,0,1,4,75.0,0.0,25.0
Ormeus Coin,1,1,63,65,1.5384615384615383,1.5384615384615383,96.92307692307692
Daox,1,0,0,1,100.0,0.0,0.0
Viewo,26,3,0,29,89.65517241379311,10.344827586206897,0.0
FanFare,21,8,2,31,67.74193548387096,25.806451612903224,6.451612903225806
Crystals,46,11,13,70,65.71428571428571,15.714285714285714,18.571428571428573
Gese,4,0,2,6,66.66666666666666,0.0,33.33333333333333
B2BX,1,0,0,1,100.0,0.0,0.0
Lamoneda,1,1,0,2,50.0,50.0,0.0
Accounting Blockchain,1,4,0,5,20.0,80.0,0.0
Nebeus,0,0,4,4,0.0,0.0,100.0
Paygine,1,0,1,2,50.0,0.0,50.0
Ivy,11,4,2,17,64.70588235294117,23.52941176470588,11.76470588235294
Selfie GO,80,71,3,154,51.94805194805194,46.103896103896105,1.948051948051948
Keplertek,5,0,1,6,83.33333333333334,0.0,16.666666666666664
Ink,5380,2119,2155,9654,55.72819556660452,21.949451004764864,22.32235342863062
Kimera,26,6,28,60,43.333333333333336,10.0,46.66666666666666
Prime Ball,15,2,3,20,75.0,10.0,15.0
Aitheon,2,0,1,3,66.66666666666666,0.0,33.33333333333333
TaTaTu,28,2,10,40,70.0,5.0,25.0
SupPorter,59,19,20,98,60.204081632653065,19.387755102040817,20.40816326530612
Acudeen,5,0,0,5,100.0,0.0,0.0
VIMANA,22,4,4,30,73.33333333333333,13.333333333333334,13.333333333333334
DeNet,6,0,0,6,100.0,0.0,0.0
Goldma,13,9,6,28,46.42857142857143,32.142857142857146,21.428571428571427
Ommer,223,56,42,321,69.47040498442367,17.445482866043612,13.084112149532707
PO8,3,0,0,3,100.0,0.0,0.0
SmartMesh,1,0,0,1,100.0,0.0,0.0
ATN,24,63,25,112,21.428571428571427,56.25,22.321428571428573
Luna,281,91,81,453,62.03090507726269,20.08830022075055,17.880794701986755
Fenix,22,2,1,25,88.0,8.0,4.0
Planport,0,1,0,1,0.0,100.0,0.0
DateCoin,7,0,0,7,100.0,0.0,0.0
Genexi,5,3,9,17,29.411764705882355,17.647058823529413,52.94117647058824
mCoin,53,9,44,106,50.0,8.49056603773585,41.50943396226416
CONDA,112,58,16,186,60.215053763440864,31.18279569892473,8.60215053763441
Koumei,7,8,10,25,28.000000000000004,32.0,40.0
SKYFchain,41,2,0,43,95.34883720930232,4.651162790697675,0.0
Fructus,0,2,19,21,0.0,9.523809523809524,90.47619047619048
Horizon,51,28,4,83,61.44578313253012,33.734939759036145,4.819277108433735
TowerBee,2,1,0,3,66.66666666666666,33.33333333333333,0.0
MST,70,40,40,150,46.66666666666666,26.666666666666668,26.666666666666668
ETHERC,1,0,3,4,25.0,0.0,75.0
DINO,34,3,16,53,64.15094339622641,5.660377358490567,30.18867924528302
LaborCrypto,9,0,0,9,100.0,0.0,0.0
Byteball,72,19,10,101,71.28712871287128,18.81188118811881,9.9009900990099
GrabAMeal,3,0,0,3,100.0,0.0,0.0
CarLive Chain,0,2,14,16,0.0,12.5,87.5
WONO,3,0,0,3,100.0,0.0,0.0
SelfSell,9,0,0,9,100.0,0.0,0.0
ICO Pass,6,0,0,6,100.0,0.0,0.0
Amicorum Live,0,1,0,1,0.0,100.0,0.0
Global REIT,14,12,10,36,38.88888888888889,33.33333333333333,27.77777777777778
WizeBit,8,0,0,8,100.0,0.0,0.0
Zichain,1,0,0,1,100.0,0.0,0.0
Tradingene,3,0,0,3,100.0,0.0,0.0
Birdchain,21,7,0,28,75.0,25.0,0.0
Blue Whale,18,13,8,39,46.15384615384615,33.33333333333333,20.51282051282051
GoldMint,6,14,3,23,26.08695652173913,60.86956521739131,13.043478260869565
EvolutionOS,9,1,3,13,69.23076923076923,7.6923076923076925,23.07692307692308
Linfinity,8,4,0,12,66.66666666666666,33.33333333333333,0.0
Cortex,9,7,1,17,52.94117647058824,41.17647058823529,5.88235294117647
Crowd for Angels,3,0,0,3,100.0,0.0,0.0
Iconiq Lab,4,2,0,6,66.66666666666666,33.33333333333333,0.0
Arousal,12,0,1,13,92.3076923076923,0.0,7.6923076923076925
CGCX,37,1,0,38,97.36842105263158,2.631578947368421,0.0
WULET,42,10,0,52,80.76923076923077,19.230769230769237,0.0
Elysian,5,0,0,5,100.0,0.0,0.0
Lancer Network,3,0,0,3,100.0,0.0,0.0
Safe Haven,6,12,5,23,26.08695652173913,52.17391304347826,21.73913043478261
ARAW Token,6,5,0,11,54.54545454545454,45.45454545454545,0.0
DICEGAME,0,1,0,1,0.0,100.0,0.0
BeepBeep Nation,0,0,1,1,0.0,0.0,100.0
ABCC Exchange,11,6,0,17,64.70588235294117,35.294117647058826,0.0
Deconet,3,0,0,3,100.0,0.0,0.0
DataBlockchain,3,0,0,3,100.0,0.0,0.0
RankingBall,21,0,1,22,95.45454545454544,0.0,4.545454545454546
Bubbletone,21,0,0,21,100.0,0.0,0.0
MPCX,2,0,0,2,100.0,0.0,0.0
XCHNG,32,2,10,44,72.72727272727273,4.545454545454546,22.727272727272727
TrustLogics,23,0,0,23,100.0,0.0,0.0
BitRent,1,0,0,1,100.0,0.0,0.0
Free Market Token,5,2,0,7,71.42857142857143,28.57142857142857,0.0
StarChain,4,0,0,4,100.0,0.0,0.0
ABitchain,0,0,1,1,0.0,0.0,100.0
AI Gaming,1,0,0,1,100.0,0.0,0.0
Blockport,86,12,4,102,84.31372549019608,11.76470588235294,3.92156862745098
BitMinutes,1,0,0,1,100.0,0.0,0.0
BFEX,2,0,0,2,100.0,0.0,0.0
ApolloChain,1,2,0,3,33.33333333333333,66.66666666666666,0.0
uRunIt,1,0,0,1,100.0,0.0,0.0
CFun,3,0,0,3,100.0,0.0,0.0
Cryde,20,4,0,24,83.33333333333334,16.666666666666664,0.0
Terra Virtua,5,0,0,5,100.0,0.0,0.0
Olympus Labs,15,1,6,22,68.18181818181817,4.545454545454546,27.27272727272727
Proton,27,14,4,45,60.0,31.11111111111111,8.88888888888889
Zeex,11,2,1,14,78.57142857142857,14.285714285714285,7.142857142857142
AutoBay,18,0,3,21,85.71428571428571,0.0,14.285714285714285
4NEW,40,7,10,57,70.17543859649122,12.280701754385964,17.543859649122805
GladAge,2,0,0,2,100.0,0.0,0.0
Indorse,11,1,0,12,91.66666666666666,8.333333333333332,0.0
Unboxed,55,3,34,92,59.78260869565217,3.260869565217391,36.95652173913043
MetaMorph,10,5,0,15,66.66666666666666,33.33333333333333,0.0
0Chain,33,2,4,39,84.61538461538461,5.128205128205128,10.256410256410255
Smart Trip Platform,3,0,0,3,100.0,0.0,0.0
TrustNote,9,1,0,10,90.0,10.0,0.0
Parsec Frontiers,15,3,3,21,71.42857142857143,14.285714285714285,14.285714285714285
Mine Coin,8,0,2,10,80.0,0.0,20.0
BITRUST,25,20,1,46,54.34782608695652,43.47826086956522,2.1739130434782608
DeepToken,0,3,3,6,0.0,50.0,50.0
Workcoin,4,0,7,11,36.36363636363637,0.0,63.63636363636363
McFly,0,0,1,1,0.0,0.0,100.0
CoinMetro,27,76,2,105,25.71428571428571,72.38095238095238,1.9047619047619049
Kryptono Exchange,5,0,0,5,100.0,0.0,0.0
dApp Builder,8,0,0,8,100.0,0.0,0.0
PreVUE,33,6,7,46,71.73913043478261,13.043478260869565,15.217391304347828
Urbit,17,9,3,29,58.620689655172406,31.03448275862069,10.344827586206897
Boosto,13,7,2,22,59.09090909090909,31.818181818181817,9.090909090909092
Anything App,48,21,3,72,66.66666666666666,29.166666666666668,4.166666666666666
BIOK,1,0,1,2,50.0,0.0,50.0
BITMILLEX,1,0,0,1,100.0,0.0,0.0
Bidipass,2,0,0,2,100.0,0.0,0.0
Sentinel Protocol,26,4,7,37,70.27027027027027,10.81081081081081,18.91891891891892
MoneyToken,0,6,0,6,0.0,100.0,0.0
Bitsum,5,1,0,6,83.33333333333334,16.666666666666664,0.0
Endorsit,3,1,0,4,75.0,25.0,0.0
SDChain,4,1,0,5,80.0,20.0,0.0
Mingo,14,7,7,28,50.0,25.0,25.0
Block Broker,2,0,0,2,100.0,0.0,0.0
Hyperion,8,1,1,10,80.0,10.0,10.0
Golden Currency,4,3,1,8,50.0,37.5,12.5
DigiPulse,20,37,15,72,27.77777777777778,51.388888888888886,20.833333333333336
EXCHAIN,6,5,18,29,20.689655172413797,17.24137931034483,62.06896551724138
Spindle,25,7,3,35,71.42857142857143,20.0,8.571428571428571
SEDA,30,8,4,42,71.42857142857143,19.047619047619047,9.523809523809524
ViValid,21,0,0,21,100.0,0.0,0.0
MBYS,22,9,13,44,50.0,20.454545454545457,29.545454545454547
Xenchain,1,0,1,2,50.0,0.0,50.0
Kakushin,3,0,0,3,100.0,0.0,0.0
EVO,774,234,173,1181,65.5376799322608,19.813717188823038,14.648602878916172
Strykz,0,0,1,1,0.0,0.0,100.0
KELTA,3,6,1,10,30.0,60.0,10.0
RAWG,30,4,0,34,88.23529411764706,11.76470588235294,0.0
AICT,19,16,8,43,44.18604651162791,37.2093023255814,18.6046511627907
Meshbox,16,9,6,31,51.61290322580645,29.03225806451613,19.35483870967742
eosDAC,1,0,0,1,100.0,0.0,0.0
Superset,28,6,8,42,66.66666666666666,14.285714285714285,19.047619047619047
Coinpaws,3,0,0,3,100.0,0.0,0.0
Trident Group,4,1,8,13,30.76923076923077,7.6923076923076925,61.53846153846154
Prontapay,1,0,0,1,100.0,0.0,0.0
Akaiito,0,2,0,2,0.0,100.0,0.0
ENTRY,242,83,70,395,61.26582278481013,21.012658227848103,17.72151898734177
Digitize,17,0,0,17,100.0,0.0,0.0
VinChain,8,0,6,14,57.14285714285714,0.0,42.85714285714285
Pecunio,40,4,1,45,88.88888888888889,8.88888888888889,2.2222222222222223
Vexanium,7,0,0,7,100.0,0.0,0.0
QRYPTOS Exchange,3,0,0,3,100.0,0.0,0.0
THEKEY,22,2,1,25,88.0,8.0,4.0
EchoLink,20,4,2,26,76.92307692307693,15.384615384615383,7.6923076923076925
Marginless,3,0,0,3,100.0,0.0,0.0
ABLE,4994,2641,1653,9288,53.76830318690784,28.434539190353146,17.797157622739018
Cosmochain,9,4,0,13,69.23076923076923,30.76923076923077,0.0
ChronoBank,14,2,5,21,66.66666666666666,9.523809523809524,23.809523809523807
BitRewards,1,0,2,3,33.33333333333333,0.0,66.66666666666666
Vanig,7,1,0,8,87.5,12.5,0.0
London Football Exchange,4,0,1,5,80.0,0.0,20.0
SurruS,1,1,1,3,33.33333333333333,33.33333333333333,33.33333333333333
CPROP,22,5,0,27,81.48148148148148,18.51851851851852,0.0
Bundle,23,8,9,40,57.49999999999999,20.0,22.5
3DES,14,16,2,32,43.75,50.0,6.25
Contract Vault,5,0,0,5,100.0,0.0,0.0
Modex,12,0,0,12,100.0,0.0,0.0
Modorr,0,1,0,1,0.0,100.0,0.0
Biotron,18,13,3,34,52.94117647058824,38.23529411764706,8.823529411764707
Berith,3,0,0,3,100.0,0.0,0.0
Moneda,4,2,2,8,50.0,25.0,25.0
BitLumens,10,0,2,12,83.33333333333334,0.0,16.666666666666664
Union,127,48,23,198,64.14141414141415,24.24242424242424,11.616161616161616
Potentiam,7,0,0,7,100.0,0.0,0.0
LangNet,1,6,0,7,14.285714285714285,85.71428571428571,0.0
Ambr,37,7,7,51,72.54901960784314,13.725490196078432,13.725490196078432
Snovio,32,5,60,97,32.98969072164948,5.154639175257731,61.855670103092784
Alvalor,30,10,5,45,66.66666666666666,22.22222222222222,11.11111111111111
Triggmine,2,0,0,2,100.0,0.0,0.0
Thorium,1,1,2,4,25.0,25.0,50.0
Sport X,0,1,0,1,0.0,100.0,0.0
MOS,3984,1803,1392,7179,55.495194316757214,25.114918512327623,19.38988717091517
Game Loot Network,18,0,0,18,100.0,0.0,0.0
MyDFS,1,1,0,2,50.0,50.0,0.0
Semux,13,1,6,20,65.0,5.0,30.0
Storweey,2,0,0,2,100.0,0.0,0.0
NWP Solution,2,0,0,2,100.0,0.0,0.0
Kinguin,4,9,0,13,30.76923076923077,69.23076923076923,0.0
Goldiam,11,6,0,17,64.70588235294117,35.294117647058826,0.0
HOLD,1579,717,579,2875,54.92173913043479,24.93913043478261,20.139130434782608
BCharity,9,0,0,9,100.0,0.0,0.0
ALAX,94,10,7,111,84.68468468468468,9.00900900900901,6.306306306306306
Crypto Angel,13,3,2,18,72.22222222222221,16.666666666666664,11.11111111111111
Flashmoni,4,0,0,4,100.0,0.0,0.0
Disciplina,14,7,3,24,58.333333333333336,29.166666666666668,12.5
Birake,1,0,0,1,100.0,0.0,0.0
ExtraCredit,3,0,0,3,100.0,0.0,0.0
HowDoo,97,3,4,104,93.26923076923076,2.8846153846153846,3.8461538461538463
SANCOJ,2,1,0,3,66.66666666666666,33.33333333333333,0.0
Smart Unit,14,0,0,14,100.0,0.0,0.0
Papyrus,1,0,0,1,100.0,0.0,0.0
Talao,1,0,0,1,100.0,0.0,0.0
Etheal,2,1,0,3,66.66666666666666,33.33333333333333,0.0
Safein,0,0,1,1,0.0,0.0,100.0
Decibels,2,0,0,2,100.0,0.0,0.0
MF Chain,12,0,0,12,100.0,0.0,0.0
Cryptelo,3,0,0,3,100.0,0.0,0.0
Cartel,56,21,296,373,15.013404825737265,5.630026809651475,79.35656836461126
Measurable Data Token,7,0,1,8,87.5,0.0,12.5
Blok,7,3,5,15,46.66666666666666,20.0,33.33333333333333
AdSigma,1,0,0,1,100.0,0.0,0.0
Instant Assets Tokens,3,0,0,3,100.0,0.0,0.0
Algebraix,25,1,0,26,96.15384615384616,3.8461538461538463,0.0
Chimaera,2,0,0,2,100.0,0.0,0.0
Essentia,232,190,171,593,39.12310286677909,32.04047217537943,28.836424957841484
Pibble,10,8,12,30,33.33333333333333,26.666666666666668,40.0
eCharge,16,17,1,34,47.05882352941176,50.0,2.941176470588235
Flux,136,26,24,186,73.11827956989248,13.978494623655912,12.903225806451612
LAPO,13,12,38,63,20.634920634920636,19.047619047619047,60.31746031746032
VeriME,1,0,0,1,100.0,0.0,0.0
Crestonium,0,0,2,2,0.0,0.0,100.0
OS University,14,0,0,14,100.0,0.0,0.0
Friend Unifying Platform,0,23,0,23,0.0,100.0,0.0
Photochain,24,13,14,51,47.05882352941176,25.49019607843137,27.450980392156865
Aeternum,25,14,8,47,53.191489361702125,29.78723404255319,17.02127659574468
Aphelion,17,4,41,62,27.41935483870968,6.451612903225806,66.12903225806451
Koios,0,0,1,1,0.0,0.0,100.0
Blockshipping,1,0,0,1,100.0,0.0,0.0
Trifid,26,7,5,38,68.42105263157895,18.421052631578945,13.157894736842104
DarcMatter,3,0,0,3,100.0,0.0,0.0
Signals,62,66,11,139,44.60431654676259,47.482014388489205,7.913669064748201
Oyster Shell,9,2,1,12,75.0,16.666666666666664,8.333333333333332
Viola,61,55,75,191,31.93717277486911,28.79581151832461,39.26701570680628
Cappasity,19,0,3,22,86.36363636363636,0.0,13.636363636363637
PHI,604,275,324,1203,50.20781379883624,22.8595178719867,26.93266832917705
Gluon,8,5,4,17,47.05882352941176,29.411764705882355,23.52941176470588
Fishcoin,10,0,0,10,100.0,0.0,0.0
A2B Taxi,2,0,0,2,100.0,0.0,0.0
Monanex,0,2,0,2,0.0,100.0,0.0
Gladius,6,0,26,32,18.75,0.0,81.25
Elementh,8,0,6,14,57.14285714285714,0.0,42.85714285714285
Callisto,3,0,0,3,100.0,0.0,0.0
CIBUS,16,0,2,18,88.88888888888889,0.0,11.11111111111111
BitNautic,2,0,0,2,100.0,0.0,0.0
WOTER,3,0,0,3,100.0,0.0,0.0
Ethearnal,15,0,0,15,100.0,0.0,0.0
Bitcore,73,1,0,74,98.64864864864865,1.351351351351351,0.0
Corridor Finance,0,0,0,0,0.0,0.0,0.0
Nyan Heroes,1,0,0,1,100.0,0.0,0.0
Ouinex,0,0,0,0,0.0,0.0,0.0
ether.fi,0,0,0,0,0.0,0.0,0.0
Rain.fi,0,0,0,0,0.0,0.0,0.0
LI.FI,0,0,0,0,0.0,0.0,0.0
nftperp,0,0,0,0,0.0,0.0,0.0
Kinetix Finance,0,0,0,0,0.0,0.0,0.0
Biokript,0,0,0,0,0.0,0.0,0.0
GaiaNet,0,0,0,0,0.0,0.0,0.0
Sender Labs,0,0,0,0,0.0,0.0,0.0
Marginly,0,0,0,0,0.0,0.0,0.0
Anichess,0,0,0,0,0.0,0.0,0.0
Quantcheck,0,0,0,0,0.0,0.0,0.0
EVAA Protocol,0,0,0,0,0.0,0.0,0.0
CEX.IO,0,0,0,0,0.0,0.0,0.0
OpenGPU Network,0,0,0,0,0.0,0.0,0.0
Gravita Protocol,0,0,0,0,0.0,0.0,0.0
AutoLayer,0,0,0,0,0.0,0.0,0.0
Dwinity,0,0,0,0,0.0,0.0,0.0
Zyfi,0,0,0,0,0.0,0.0,0.0
Another-1,0,0,0,0,0.0,0.0,0.0
IntentX,0,0,0,0,0.0,0.0,0.0
Reya Network,0,0,0,0,0.0,0.0,0.0
OrangeLayer,0,0,0,0,0.0,0.0,0.0
InceptionLRT,0,0,0,0,0.0,0.0,0.0
Ultimate Digits,0,0,0,0,0.0,0.0,0.0
MPRO Lab,0,0,0,0,0.0,0.0,0.0
BlockGames,0,0,0,0,0.0,0.0,0.0
Warden Protocol,0,0,0,0,0.0,0.0,0.0
Base Name Service,0,0,0,0,0.0,0.0,0.0
StarryNift,0,0,0,0,0.0,0.0,0.0
Battle Showdown: Gambit,0,0,0,0,0.0,0.0,0.0
Data Ownership Protocol,0,0,0,0,0.0,0.0,0.0
ZKE Exchange,0,0,0,0,0.0,0.0,0.0
Aries Markets,0,0,0,0,0.0,0.0,0.0
Tortuga Finance,0,0,0,0,0.0,0.0,0.0
Aptin Finance,0,0,0,0,0.0,0.0,0.0
Gomble Games,0,0,0,0,0.0,0.0,0.0
KiloEx,0,0,0,0,0.0,0.0,0.0
Rio Network,0,0,0,0,0.0,0.0,0.0
Aftermath Finance,0,0,0,0,0.0,0.0,0.0
INIT Capital,0,0,0,0,0.0,0.0,0.0
BRC-20 DEX,0,0,0,0,0.0,0.0,0.0
Unigraph Protocol,0,0,0,0,0.0,0.0,0.0
Virtual Labs,0,0,0,0,0.0,0.0,0.0
Sound.xyz,0,0,0,0,0.0,0.0,0.0
Seamless Protocol,0,0,0,0,0.0,0.0,0.0
Hinkal,0,0,0,0,0.0,0.0,0.0
Scroll Name Service,0,0,0,0,0.0,0.0,0.0
Derivio,0,0,0,0,0.0,0.0,0.0
Forcefi,0,0,0,0,0.0,0.0,0.0
Okto x QuickSwap,0,0,0,0,0.0,0.0,0.0
MoonlandMeta,0,0,0,0,0.0,0.0,0.0
Chainflip,0,0,0,0,0.0,0.0,0.0
Web3Eco,0,0,0,0,0.0,0.0,0.0
TapiocaDAO,0,0,0,0,0.0,0.0,0.0
zkSync id,0,0,0,0,0.0,0.0,0.0
Tevaera,0,0,0,0,0.0,0.0,0.0
Cedro Finance,0,0,0,0,0.0,0.0,0.0
StarkNet ID,0,0,0,0,0.0,0.0,0.0
Aark Digital,0,0,0,0,0.0,0.0,0.0
MUFEX,0,0,0,0,0.0,0.0,0.0
Housebets.io,0,0,0,0,0.0,0.0,0.0
zkSync Name Service,0,0,0,0,0.0,0.0,0.0
Polynomial Protocol,0,0,0,0,0.0,0.0,0.0
Daoversal,0,0,0,0,0.0,0.0,0.0
Velvet.Capital,0,0,0,0,0.0,0.0,0.0
Tide Exchange,0,0,0,0,0.0,0.0,0.0
AlienSwap,0,0,0,0,0.0,0.0,0.0
Collab.Land,0,0,0,0,0.0,0.0,0.0
Nexon Finance,0,0,0,0,0.0,0.0,0.0
Enchanter Finance,0,0,0,0,0.0,0.0,0.0
objkt.com,0,0,0,0,0.0,0.0,0.0
TiTi Protocol,0,0,0,0,0.0,0.0,0.0
JediSwap,0,0,0,0,0.0,0.0,0.0
Deepwaters,0,0,0,0,0.0,0.0,0.0
Alpha Road,0,0,0,0,0.0,0.0,0.0
Binance Account Bound (BAB),0,0,0,0,0.0,0.0,0.0
ZKEX,0,0,0,0,0.0,0.0,0.0
Ragnar Protocol,0,0,0,0,0.0,0.0,0.0
AllStars Digital,0,0,0,0,0.0,0.0,0.0
Xiroverse,0,0,0,0,0.0,0.0,0.0
Bridgesplit,0,0,0,0,0.0,0.0,0.0
Element Finance,0,0,0,0,0.0,0.0,0.0
LandDAO,0,0,0,0,0.0,0.0,0.0
Fuji DAO,0,0,0,0,0.0,0.0,0.0
Craft Economy,0,0,0,0,0.0,0.0,0.0
X2Y2,0,0,0,0,0.0,0.0,0.0
Pika Protocol,0,0,0,0,0.0,0.0,0.0
Chic Cow & Bullzz,0,0,0,0,0.0,0.0,0.0
Hedgehog Markets,0,0,0,0,0.0,0.0,0.0
Instrumental Finance,0,0,0,0,0.0,0.0,0.0
Gro Protocol,0,0,0,0,0.0,0.0,0.0
Gaia EverWorld,0,0,0,0,0.0,0.0,0.0
Cozy Finance,0,0,0,0,0.0,0.0,0.0
InPoker,0,0,0,0,0.0,0.0,0.0
BullionFX,0,0,0,0,0.0,0.0,0.0
Angel Protocol,0,0,0,0,0.0,0.0,0.0
HAI DAMO,0,0,0,0,0.0,0.0,0.0
VoltNFT,0,0,0,0,0.0,0.0,0.0
Spar Finance,0,0,0,0,0.0,0.0,0.0
NEFTiPEDiA,0,0,0,0,0.0,0.0,0.0
BarterTrade,0,0,0,0,0.0,0.0,0.0
Crypto Thrills,0,0,0,0,0.0,0.0,0.0
NFTMart,0,0,0,0,0.0,0.0,0.0
My Lotto Coin,0,0,0,0,0.0,0.0,0.0
Utile Network,0,0,0,0,0.0,0.0,0.0
Invest & Hodl,0,0,0,0,0.0,0.0,0.0
MarcoPolo Protocol,0,0,0,0,0.0,0.0,0.0
Metex,0,0,0,0,0.0,0.0,0.0
SwanFinance,0,0,0,0,0.0,0.0,0.0
Massnet,0,0,0,0,0.0,0.0,0.0
Intexcoin,0,0,0,0,0.0,0.0,0.0
NowEx,0,0,0,0,0.0,0.0,0.0
StellarPayGlobal,0,0,0,0,0.0,0.0,0.0
DRK DeFi,0,0,0,0,0.0,0.0,0.0
FunderOne,0,0,0,0,0.0,0.0,0.0
VNT Chain Labs,0,0,0,0,0.0,0.0,0.0
ICURY,0,0,0,0,0.0,0.0,0.0
Foodecent,0,0,0,0,0.0,0.0,0.0
Social Club Rocks,0,0,0,0,0.0,0.0,0.0
B One Payment,0,0,0,0,0.0,0.0,0.0
Bitcoin Turbo Koin Giveaway,0,0,0,0,0.0,0.0,0.0
JIL TOKENS,0,0,0,0,0.0,0.0,0.0
K-Tune,0,0,0,0,0.0,0.0,0.0
Netspot Solutions,0,0,0,0,0.0,0.0,0.0
BitCollar,0,0,0,0,0.0,0.0,0.0
Wavesbet,0,0,0,0,0.0,0.0,0.0
BlocBox,0,0,0,0,0.0,0.0,0.0
Neo Smart Energy,0,0,0,0,0.0,0.0,0.0
Tune.fm,0,0,0,0,0.0,0.0,0.0
Swiftex,0,0,0,0,0.0,0.0,0.0
Beowulf Blockchain,0,0,0,0,0.0,0.0,0.0
FreedomOptions,0,0,0,0,0.0,0.0,0.0
Crypto Tribunal,0,0,0,0,0.0,0.0,0.0
KAPPI,0,0,0,0,0.0,0.0,0.0
BitQuant,0,0,0,0,0.0,0.0,0.0
Binance JEX,0,0,0,0,0.0,0.0,0.0
NOS Initiative,0,0,0,0,0.0,0.0,0.0
Adrenaline AI,0,0,0,0,0.0,0.0,0.0
OilWellCoin,0,0,0,0,0.0,0.0,0.0
SpockChain,0,0,0,0,0.0,0.0,0.0
BAGS token,0,0,0,0,0.0,0.0,0.0
Netbox.Global,0,0,0,0,0.0,0.0,0.0
PIEXGO,0,0,0,0,0.0,0.0,0.0
Counos Platform,0,0,0,0,0.0,0.0,0.0
BTCOW,0,0,0,0,0.0,0.0,0.0
PBET,0,0,0,0,0.0,0.0,0.0
Comno Network,0,0,0,0,0.0,0.0,0.0
Blaze Protocol,0,0,0,0,0.0,0.0,0.0
Ubrica,1,0,0,1,100.0,0.0,0.0
Product Protocol,0,0,0,0,0.0,0.0,0.0
Creamcoin,0,0,0,0,0.0,0.0,0.0
Xprivate Chat,0,0,0,0,0.0,0.0,0.0
diamDEXX,0,0,0,0,0.0,0.0,0.0
Minglechain,0,0,0,0,0.0,0.0,0.0
Dukascoin,0,0,0,0,0.0,0.0,0.0
SixDomainChain,0,0,0,0,0.0,0.0,0.0
SOCIAL CHAINS,0,0,0,0,0.0,0.0,0.0
Reserve Round 2,0,0,0,0,0.0,0.0,0.0
DVMarketplace,0,0,0,0,0.0,0.0,0.0
AllSesame,0,0,0,0,0.0,0.0,0.0
BTSCOIN,0,0,0,0,0.0,0.0,0.0
CoinHe,0,0,0,0,0.0,0.0,0.0
Venoty,0,0,0,0,0.0,0.0,0.0
Tipestry,0,0,0,0,0.0,0.0,0.0
Betinance,0,0,0,0,0.0,0.0,0.0
Coinquista,0,0,0,0,0.0,0.0,0.0
Five Colors Coin,0,0,0,0,0.0,0.0,0.0
Chelle Coin,0,0,0,0,0.0,0.0,0.0
Pukkamex,0,0,0,0,0.0,0.0,0.0
eden.best,0,0,0,0,0.0,0.0,0.0
Trade Nexi,0,0,0,0,0.0,0.0,0.0
OpenWeb Network,0,0,0,0,0.0,0.0,0.0
Block and Chain,0,0,0,0,0.0,0.0,0.0
Files.fm,0,0,0,0,0.0,0.0,0.0
Havaex,0,0,0,0,0.0,0.0,0.0
Purple Butterfly Trading,0,0,0,0,0.0,0.0,0.0
Sheepcoin,0,0,0,0,0.0,0.0,0.0
VINE Protocol,0,0,0,0,0.0,0.0,0.0
Opensea Traders,0,0,0,0,0.0,0.0,0.0
Mofi Finance,0,0,0,0,0.0,0.0,0.0
Nodis,0,0,0,0,0.0,0.0,0.0
Solve.Care,0,0,0,0,0.0,0.0,0.0
4hiphop,0,0,0,0,0.0,0.0,0.0
Almeedex,0,0,0,0,0.0,0.0,0.0
WOWX,0,0,0,0,0.0,0.0,0.0
KRONN,0,0,0,0,0.0,0.0,0.0
GLAD Network,0,0,0,0,0.0,0.0,0.0
Precium Foundation,0,0,0,0,0.0,0.0,0.0
Z-POP DREAM,0,0,0,0,0.0,0.0,0.0
Daily Coin News,0,0,0,0,0.0,0.0,0.0
DataOnBlock,0,0,0,0,0.0,0.0,0.0
Afincoin,0,0,0,0,0.0,0.0,0.0
DecentraX,0,0,0,0,0.0,0.0,0.0
ShareMeAll,0,0,0,0,0.0,0.0,0.0
Grailum Lab,0,0,0,0,0.0,0.0,0.0
Game Fanz,0,0,0,0,0.0,0.0,0.0
Ares Tech,0,0,0,0,0.0,0.0,0.0
PerksCoin,0,0,0,0,0.0,0.0,0.0
HotelLoad,0,0,0,0,0.0,0.0,0.0
OmniBazaar,0,0,0,0,0.0,0.0,0.0
Platon Finance,0,0,0,0,0.0,0.0,0.0
idap.io,0,0,0,0,0.0,0.0,0.0
Indochain,0,0,0,0,0.0,0.0,0.0
Liquid (Raffle),0,0,0,0,0.0,0.0,0.0
Dsion,0,0,0,0,0.0,0.0,0.0
Bancryp,0,0,0,0,0.0,0.0,0.0
MEDoctor,0,0,0,0,0.0,0.0,0.0
Cures Token,0,0,0,0,0.0,0.0,0.0
Mobile Token Bank,0,0,0,0,0.0,0.0,0.0
OcNet,0,0,0,0,0.0,0.0,0.0
Sonata.ai,0,0,0,0,0.0,0.0,0.0
Varius World Tech,0,0,2,2,0.0,0.0,100.0
Tokedo,0,0,0,0,0.0,0.0,0.0
PGF500,0,0,0,0,0.0,0.0,0.0
Datafund,0,0,0,0,0.0,0.0,0.0
Namacoin,0,0,0,0,0.0,0.0,0.0
QUBAY,0,0,0,0,0.0,0.0,0.0
TheFund.io,0,0,0,0,0.0,0.0,0.0
Tradesprite,0,0,0,0,0.0,0.0,0.0
XRP by Huobi,0,0,0,0,0.0,0.0,0.0
FanChain,0,0,0,0,0.0,0.0,0.0
FiiiCoin,0,0,0,0,0.0,0.0,0.0
HintChain,0,0,0,0,0.0,0.0,0.0
FEEDOCK,0,0,0,0,0.0,0.0,0.0
HiLynk,0,0,0,0,0.0,0.0,0.0
Mycro Jobs,0,0,0,0,0.0,0.0,0.0
GoFind.World,0,0,0,0,0.0,0.0,0.0
Crypt-ON,0,0,0,0,0.0,0.0,0.0
CoinJax,0,0,0,0,0.0,0.0,0.0
FortKnoxster,0,0,0,0,0.0,0.0,0.0
Truwho,0,0,0,0,0.0,0.0,0.0
Kidbizo,0,0,0,0,0.0,0.0,0.0
ETH Birds,0,0,0,0,0.0,0.0,0.0
Bitsrent,0,0,0,0,0.0,0.0,0.0
Cryptocoin Insurance,0,0,0,0,0.0,0.0,0.0
Job.com,0,0,0,0,0.0,0.0,0.0
MorLabs,0,0,0,0,0.0,0.0,0.0
WooshCoin,0,0,0,0,0.0,0.0,0.0
Balehu Protocol,0,0,0,0,0.0,0.0,0.0
SPIN Protocol,0,0,0,0,0.0,0.0,0.0
LogisticsX,0,0,0,0,0.0,0.0,0.0
ASOBI COIN,0,0,0,0,0.0,0.0,0.0
Nerves Foundation,0,0,0,0,0.0,0.0,0.0
Sansox,0,0,0,0,0.0,0.0,0.0
dClinic,0,0,0,0,0.0,0.0,0.0
X-Cash,0,0,0,0,0.0,0.0,0.0
Osmium Investment Coin,0,0,0,0,0.0,0.0,0.0
Contents Protocol,0,0,0,0,0.0,0.0,0.0
Beverage Cash,0,0,0,0,0.0,0.0,0.0
Spheroid Universe,2,0,0,2,100.0,0.0,0.0
X-Block,0,0,0,0,0.0,0.0,0.0
iLink2Music,0,0,0,0,0.0,0.0,0.0
Kineticex,0,0,0,0,0.0,0.0,0.0
PayX,0,0,0,0,0.0,0.0,0.0
FUNKEYpay,0,0,0,0,0.0,0.0,0.0
Papusha,0,0,0,0,0.0,0.0,0.0
Florafic,0,0,0,0,0.0,0.0,0.0
WorkChain,0,0,0,0,0.0,0.0,0.0
BrokerNekoNetwork,0,0,0,0,0.0,0.0,0.0
SUBAJ,0,0,0,0,0.0,0.0,0.0
DX.Exchange,0,0,0,0,0.0,0.0,0.0
EurekaPro,0,0,0,0,0.0,0.0,0.0
ABELE GROUP,0,0,0,0,0.0,0.0,0.0
iRide,0,0,0,0,0.0,0.0,0.0
Synthetics AI,0,0,0,0,0.0,0.0,0.0
Opporty,3,0,0,3,100.0,0.0,0.0
Blackbox Foundation,0,0,0,0,0.0,0.0,0.0
MedChain,0,0,0,0,0.0,0.0,0.0
ZeroState,0,0,0,0,0.0,0.0,0.0
MapCoin,0,0,0,0,0.0,0.0,0.0
EyeGlob.Net,0,0,0,0,0.0,0.0,0.0
Crypviser,0,0,0,0,0.0,0.0,0.0
Distributed Blocks,0,0,0,0,0.0,0.0,0.0
Fieldcoin,0,0,0,0,0.0,0.0,0.0
VEIAG,0,0,0,0,0.0,0.0,0.0
Spl.yt,0,0,0,0,0.0,0.0,0.0
unitalent,0,0,0,0,0.0,0.0,0.0
CareerChain,0,0,0,0,0.0,0.0,0.0
Thingschain,0,0,0,0,0.0,0.0,0.0
Daviescoin,0,0,0,0,0.0,0.0,0.0
TLPAC,0,0,0,0,0.0,0.0,0.0
Sports Ledger,0,0,0,0,0.0,0.0,0.0
DREAM & INDORSE,0,0,0,0,0.0,0.0,0.0
BuratinoBS,0,0,0,0,0.0,0.0,0.0
BolieCoin,0,0,0,0,0.0,0.0,0.0
RIPAEX,0,0,0,0,0.0,0.0,0.0
NeoPlace,0,0,0,0,0.0,0.0,0.0
ZeroBank,0,0,0,0,0.0,0.0,0.0
Attrace,0,0,0,0,0.0,0.0,0.0
RockerCoin,0,0,0,0,0.0,0.0,0.0
Rays Network,0,0,0,0,0.0,0.0,0.0
AIRSTAYZ,0,0,0,0,0.0,0.0,0.0
YINC,0,0,0,0,0.0,0.0,0.0
Hurtle Coin,0,0,0,0,0.0,0.0,0.0
Prime Shipping Foundation,0,0,0,0,0.0,0.0,0.0
Easy Trading Platform,0,0,0,0,0.0,0.0,0.0
STAR BIT,0,0,0,0,0.0,0.0,0.0
Bixtrim,0,0,0,0,0.0,0.0,0.0
MediLOT,0,0,0,0,0.0,0.0,0.0
HELIX Orange,0,0,0,0,0.0,0.0,0.0
AllSporter,0,0,0,0,0.0,0.0,0.0
Inmusik,0,0,0,0,0.0,0.0,0.0
TombCare,0,0,0,0,0.0,0.0,0.0
Tuurnt,0,0,0,0,0.0,0.0,0.0
Storeplex,0,0,0,0,0.0,0.0,0.0
TradeRiser,0,0,0,0,0.0,0.0,0.0
Sharevest,0,0,0,0,0.0,0.0,0.0
HEROIC.com,0,0,0,0,0.0,0.0,0.0
MiBoodle,0,0,0,0,0.0,0.0,0.0
ODMCoin,0,0,0,0,0.0,0.0,0.0
Monoreto,0,0,0,0,0.0,0.0,0.0
Grapevine World,0,0,0,0,0.0,0.0,0.0
Setteo,0,0,0,0,0.0,0.0,0.0
CryptovationX,0,0,0,0,0.0,0.0,0.0
Basis Neuro,0,0,0,0,0.0,0.0,0.0
re:factor,0,0,0,0,0.0,0.0,0.0
LendsBay,0,0,0,0,0.0,0.0,0.0
Menlo One,0,0,0,0,0.0,0.0,0.0
WeSend,0,0,0,0,0.0,0.0,0.0
Zoidcoin,0,0,0,0,0.0,0.0,0.0
No BS Crypto,0,0,0,0,0.0,0.0,0.0
Cosmecoin,0,0,0,0,0.0,0.0,0.0
XMED Chain,0,0,0,0,0.0,0.0,0.0
MAKEAFOLIO,0,0,0,0,0.0,0.0,0.0
Iris.ai,0,0,0,0,0.0,0.0,0.0
Find.Exchange,0,0,0,0,0.0,0.0,0.0
Box 2 Table,0,0,0,0,0.0,0.0,0.0
RecordsKeeper,0,0,0,0,0.0,0.0,0.0
DATAVLT,0,0,0,0,0.0,0.0,0.0
CryptoRiya,0,0,0,0,0.0,0.0,0.0
Mjolnir Guard,0,0,0,0,0.0,0.0,0.0
PavoCoin,0,0,0,0,0.0,0.0,0.0
Brainmab,0,0,0,0,0.0,0.0,0.0
XGenomics,0,0,0,0,0.0,0.0,0.0
ASKfm 2.0,0,0,0,0,0.0,0.0,0.0
Energi Token,0,0,0,0,0.0,0.0,0.0
iRegMed,0,0,0,0,0.0,0.0,0.0
Binex.Trade,0,0,0,0,0.0,0.0,0.0
Clash & GO,0,0,0,0,0.0,0.0,0.0
Miner Edge,0,0,0,0,0.0,0.0,0.0
Neodium Network,0,0,0,0,0.0,0.0,0.0
EasyLoot,0,0,0,0,0.0,0.0,0.0
Viva Network,0,0,0,0,0.0,0.0,0.0
LeadRex,0,0,0,0,0.0,0.0,0.0
SuccessLife,0,0,0,0,0.0,0.0,0.0
ArchiCoin,0,0,0,0,0.0,0.0,0.0
CryptoHIT,0,0,0,0,0.0,0.0,0.0
JioJioMe,0,0,0,0,0.0,0.0,0.0
HODLit Network,0,0,0,0,0.0,0.0,0.0
Coinyspace,0,0,0,0,0.0,0.0,0.0
KanadeCoin,0,0,0,0,0.0,0.0,0.0
Xriba,0,0,0,0,0.0,0.0,0.0
Elepig,0,0,0,0,0.0,0.0,0.0
MD Tokens,0,0,0,0,0.0,0.0,0.0
BitImage,0,0,0,0,0.0,0.0,0.0
GLEDOS,0,0,0,0,0.0,0.0,0.0
Acute Coin,0,0,0,0,0.0,0.0,0.0
CryptoFlix,0,0,0,0,0.0,0.0,0.0
HubToken,0,0,0,0,0.0,0.0,0.0
OkeyDokey,0,0,0,0,0.0,0.0,0.0
FreelancerCoin,0,0,0,0,0.0,0.0,0.0
Coinet,0,0,0,0,0.0,0.0,0.0
DirectHome,0,0,0,0,0.0,0.0,0.0
Buzcoin,0,0,0,0,0.0,0.0,0.0
CarBlock,0,0,0,0,0.0,0.0,0.0
Bulleon,0,0,0,0,0.0,0.0,0.0
CoinCrowd,0,0,0,0,0.0,0.0,0.0
BlockStorage,0,0,0,0,0.0,0.0,0.0
XcelToken Plus,0,0,0,0,0.0,0.0,0.0
Check-Car,0,0,0,0,0.0,0.0,0.0
AbacasXchange,0,0,0,0,0.0,0.0,0.0
Ether joy,0,0,0,0,0.0,0.0,0.0
ConcertVR,0,0,0,0,0.0,0.0,0.0
Limocoinswap,0,0,0,0,0.0,0.0,0.0
Coin Governance System,0,0,0,0,0.0,0.0,0.0
Belotto,0,0,0,0,0.0,0.0,0.0
Touch. Social Network,0,0,0,0,0.0,0.0,0.0
CargoChain,0,0,0,0,0.0,0.0,0.0
Moveco,0,0,0,0,0.0,0.0,0.0
Delicia,0,0,0,0,0.0,0.0,0.0
Esports Chain,0,0,0,0,0.0,0.0,0.0
EthicHub Twitter,0,0,0,0,0.0,0.0,0.0
Assettoken,0,0,0,0,0.0,0.0,0.0
Pointium,0,0,0,0,0.0,0.0,0.0
LibertyLance,0,0,0,0,0.0,0.0,0.0
EatMeCoin,0,0,0,0,0.0,0.0,0.0
SmartO,5,3,0,8,62.5,37.5,0.0
Bit.Game,0,0,0,0,0.0,0.0,0.0
LabStart,0,0,0,0,0.0,0.0,0.0
EthicHub,1,0,0,1,100.0,0.0,0.0
LemoChain,0,0,0,0,0.0,0.0,0.0
BitFence,0,0,0,0,0.0,0.0,0.0
MaxiMine,0,0,0,0,0.0,0.0,0.0
CyteCoin,0,0,0,0,0.0,0.0,0.0
BHOM,0,0,0,0,0.0,0.0,0.0
Emrify,0,0,0,0,0.0,0.0,0.0
Hai Project,0,0,0,0,0.0,0.0,0.0
VRT World,0,0,0,0,0.0,0.0,0.0
DateMe,0,0,0,0,0.0,0.0,0.0
Helios Protocol,0,0,0,0,0.0,0.0,0.0
Gravity GZRO,0,0,0,0,0.0,0.0,0.0
Sleecoin,0,0,0,0,0.0,0.0,0.0
First Trading Ecosystem,0,0,0,0,0.0,0.0,0.0
Cybereits,0,0,0,0,0.0,0.0,0.0
Blocknubie,0,0,0,0,0.0,0.0,0.0
Blockchain Hotels 2.0,0,0,0,0,0.0,0.0,0.0
BLACKFOL.IO,0,0,0,0,0.0,0.0,0.0
WeiCrowd,0,0,0,0,0.0,0.0,0.0
StasyQ,0,0,0,0,0.0,0.0,0.0
BTU Protocol,0,0,0,0,0.0,0.0,0.0
Pantos by Bitpanda,0,0,0,0,0.0,0.0,0.0
Eniac Network,0,0,0,0,0.0,0.0,0.0
Fox Trading,0,0,0,0,0.0,0.0,0.0
PayVX,0,0,0,0,0.0,0.0,0.0
Xmoneta,0,0,0,0,0.0,0.0,0.0
AIDA Service,0,0,0,0,0.0,0.0,0.0
CashBag,0,0,0,0,0.0,0.0,0.0
Biograffi,0,0,0,0,0.0,0.0,0.0
BZLcoin,0,0,0,0,0.0,0.0,0.0
ConnectJob,0,0,0,0,0.0,0.0,0.0
Dizcovery Network,0,0,0,0,0.0,0.0,0.0
BlockFollow,0,0,0,0,0.0,0.0,0.0
webRunes,0,0,0,0,0.0,0.0,0.0
Invest in Brokers,0,0,0,0,0.0,0.0,0.0
AllStocks,0,0,0,0,0.0,0.0,0.0
DOGS,8,0,2,10,80.0,0.0,20.0
Ostium,12,4,5,21,57.14285714285714,19.047619047619047,23.809523809523807
Ancient8,3,0,0,3,100.0,0.0,0.0
Usual,86,87,51,224,38.392857142857146,38.83928571428572,22.767857142857142
BlastUP,6,13,70,89,6.741573033707865,14.606741573033707,78.65168539325843
Reactor Fusion,61,9,10,80,76.25,11.25,12.5
Merkle Trade,0,0,0,0,0.0,0.0,0.0
PancakeSwap,0,0,2,2,0.0,0.0,100.0
MYX,4,4,0,8,50.0,50.0,0.0
IBX,25,11,16,52,48.07692307692308,21.153846153846157,30.76923076923077
Texture,13,0,1,14,92.85714285714286,0.0,7.142857142857142
VaultCraft,9,12,4,25,36.0,48.0,16.0
Newtify,0,0,0,0,0.0,0.0,0.0
Lavarage,2,0,1,3,66.66666666666666,0.0,33.33333333333333
Swords & Dungeons,0,0,0,0,0.0,0.0,0.0
Macaron,1,0,1,2,50.0,0.0,50.0
Clone,13,2,3,18,72.22222222222221,11.11111111111111,16.666666666666664
Symbiotic,12,4,7,23,52.17391304347826,17.391304347826086,30.434782608695656
SuperBoring,0,0,0,0,0.0,0.0,0.0
Allora,0,0,0,0,0.0,0.0,0.0
Kroma,0,0,0,0,0.0,0.0,0.0
Amphor,0,0,0,0,0.0,0.0,0.0
ZKcandy,0,0,0,0,0.0,0.0,0.0
Napier Finance,0,0,0,0,0.0,0.0,0.0
Gate.io,0,0,0,0,0.0,0.0,0.0
Sunrise,0,0,0,0,0.0,0.0,0.0
Super Champs,0,0,0,0,0.0,0.0,0.0
Injera,0,0,0,0,0.0,0.0,0.0
PredX,3,1,0,4,75.0,25.0,0.0
Units,58,18,20,96,60.41666666666666,18.75,20.833333333333336
Camp Network,35,30,17,82,42.68292682926829,36.58536585365854,20.73170731707317
Rivalz Network,0,0,0,0,0.0,0.0,0.0
10K Dex,3,16,7,26,11.538461538461538,61.53846153846154,26.923076923076923
squid,0,0,0,0,0.0,0.0,0.0
GOAT Gaming,0,0,0,0,0.0,0.0,0.0
Hybrid,1,1,0,2,50.0,50.0,0.0
LazyOtter,0,0,0,0,0.0,0.0,0.0
Chirp,12,7,4,23,52.17391304347826,30.434782608695656,17.391304347826086
Zebra,1,1,0,2,50.0,50.0,0.0
AI Gram,0,0,0,0,0.0,0.0,0.0
Cog Finance,0,0,0,0,0.0,0.0,0.0
StakeStone,0,0,0,0,0.0,0.0,0.0
Mantle,0,0,0,0,0.0,0.0,0.0
Superposition,0,0,0,0,0.0,0.0,0.0
Symmetry Trade,0,0,0,0,0.0,0.0,0.0
Adrena,2,1,0,3,66.66666666666666,33.33333333333333,0.0
Movement,28,14,7,49,57.14285714285714,28.57142857142857,14.285714285714285
NX Finance,0,0,0,0,0.0,0.0,0.0
Superposition Finance,0,0,0,0,0.0,0.0,0.0
ORA,200,123,107,430,46.51162790697674,28.60465116279069,24.88372093023256
GammaSwap,0,0,0,0,0.0,0.0,0.0
Unite,2,2,3,7,28.57142857142857,28.57142857142857,42.85714285714285
Echelon,0,0,0,0,0.0,0.0,0.0
Rho Markets,0,0,0,0,0.0,0.0,0.0
Optopia,0,3,0,3,0.0,100.0,0.0
Zeek Network,0,0,0,0,0.0,0.0,0.0
Summer.fi,0,0,0,0,0.0,0.0,0.0
Mitosis,0,0,0,0,0.0,0.0,0.0
Voi Network,0,0,0,0,0.0,0.0,0.0
Hyperlane,0,0,0,0,0.0,0.0,0.0
NURI Exchange,0,0,0,0,0.0,0.0,0.0
f(x) Protocol,0,0,0,0,0.0,0.0,0.0
The Backwoods,6,4,5,15,40.0,26.666666666666668,33.33333333333333
Vest,232,112,86,430,53.95348837209303,26.046511627906977,20.0
Koi Finance,0,0,0,0,0.0,0.0,0.0
100x,2,0,0,2,100.0,0.0,0.0
DEGEN WAR$,0,0,0,0,0.0,0.0,0.0
Cherry,8,1,0,9,88.88888888888889,11.11111111111111,0.0
Zest Protocol,0,0,0,0,0.0,0.0,0.0
Catalyst,0,5,0,5,0.0,100.0,0.0
Mercle,2,0,0,2,100.0,0.0,0.0
GriffinAI,0,0,0,0,0.0,0.0,0.0
Captain & Company,0,0,0,0,0.0,0.0,0.0
IoTeX,0,0,0,0,0.0,0.0,0.0
CoChilli,0,0,0,0,0.0,0.0,0.0
Fhenix,0,0,0,0,0.0,0.0,0.0
Aethir,0,0,0,0,0.0,0.0,0.0
Glyph,0,0,0,0,0.0,0.0,0.0
0xAstra,0,0,0,0,0.0,0.0,0.0
SOFA,1,2,1,4,25.0,50.0,25.0
ZKsync,53,0,0,53,100.0,0.0,0.0
Revert,0,0,0,0,0.0,0.0,0.0
Nexis Network,1,0,0,1,100.0,0.0,0.0
Bitflow,0,0,0,0,0.0,0.0,0.0
KIP Protocol,0,0,0,0,0.0,0.0,0.0
Dunes,24,10,3,37,64.86486486486487,27.027027027027028,8.108108108108109
D8X,1,0,34,35,2.857142857142857,0.0,97.14285714285714
Fuel,6,8,5,19,31.57894736842105,42.10526315789473,26.31578947368421
RIZE,25,4,7,36,69.44444444444444,11.11111111111111,19.444444444444446
Jigsaw,0,1,0,1,0.0,100.0,0.0
Turtle Club,4,0,0,4,100.0,0.0,0.0
Rivo.xyz,0,0,0,0,0.0,0.0,0.0
GM Network,10,9,4,23,43.47826086956522,39.130434782608695,17.391304347826086
Pocket Protector,26,12,10,48,54.16666666666666,25.0,20.833333333333336
Olive Network,0,0,1,1,0.0,0.0,100.0
ALIENX,0,0,0,0,0.0,0.0,0.0
Solayer,1,0,0,1,100.0,0.0,0.0
Bitget Wallet,0,0,0,0,0.0,0.0,0.0
BÂ² Network,0,0,0,0,0.0,0.0,0.0
Die Last,0,0,0,0,0.0,0.0,0.0
Grindery,1,1,4,6,16.666666666666664,16.666666666666664,66.66666666666666
Degenâs Farm,0,0,0,0,0.0,0.0,0.0
Bobâs Repair,0,0,0,0,0.0,0.0,0.0
