airdrop_name,positive,neutral,negative,total,positive_percentage,neutral_percentage,negative_percentage
Corridor Finance,0,0,0,0,0,0,0
Nyan Heroes,1,0,0,1,100.0,0.0,0.0
Cyber,20,3,2,25,80.0,12.0,8.0
Ouinex,0,0,0,0,0,0,0
zkSync,53,0,0,53,100.0,0.0,0.0
DOGS,8,0,2,10,80.0,0.0,20.0
Pontem,0,0,0,0,0,0,0
ether.fi,0,0,0,0,0,0,0
Ostium,12,4,5,21,57.14285714285714,19.047619047619047,23.809523809523807
Ancient8,3,0,0,3,100.0,0.0,0.0
Usual,86,87,51,224,38.392857142857146,38.839285714285715,22.767857142857142
BlastUP,6,13,70,89,6.741573033707865,14.606741573033707,78.65168539325843
Base,246,137,76,459,53.59477124183007,29.847494553376908,16.55773420479303
Reactor Fusion,61,9,10,80,76.25,11.25,12.5
Merkle Trade,0,0,0,0,0,0,0
PancakeSwap,0,0,2,2,0.0,0.0,100.0
MYX,4,4,0,8,50.0,50.0,0.0
IBX,25,11,16,52,48.07692307692308,21.153846153846153,30.76923076923077
Texture,13,0,1,14,92.85714285714286,0.0,7.142857142857142
VaultCraft,9,12,4,25,36.0,48.0,16.0
Newtify,0,0,0,0,0,0,0
Grass,1,4,3,8,12.5,50.0,37.5
Lavarage,2,0,1,3,66.66666666666666,0.0,33.33333333333333
Scroll,13,0,5,18,72.22222222222221,0.0,27.77777777777778
Swords & Dungeons,0,0,0,0,0,0,0
Rain.fi,0,0,0,0,0,0,0
Macaron,1,0,1,2,50.0,0.0,50.0
Clone,13,2,3,18,72.22222222222221,11.11111111111111,16.666666666666664
Symbiotic,12,4,7,23,52.17391304347826,17.391304347826086,30.434782608695656
SuperBoring,0,0,0,0,0,0,0
Mocaverse,0,0,0,0,0,0,0
Allora,0,0,0,0,0,0,0
Jupiter,0,0,0,0,0,0,0
Kroma,0,0,0,0,0,0,0
Amphor,0,0,0,0,0,0,0
LI.FI,0,0,0,0,0,0,0
ZKcandy,0,0,0,0,0,0,0
Napier Finance,0,0,0,0,0,0,0
Gate.io,0,0,0,0,0,0,0
Sunrise,0,0,0,0,0,0,0
DeBank,0,0,0,0,0,0,0
Rage Trade,0,0,0,0,0,0,0
Zircuit,0,0,0,0,0,0,0
Super Champs,0,0,0,0,0,0,0
Injera,0,0,0,0,0,0,0
PredX,3,1,0,4,75.0,25.0,0.0
Units,58,18,20,96,60.416666666666664,18.75,20.833333333333336
Camp Network,35,30,17,82,42.68292682926829,36.58536585365854,20.73170731707317
Rivalz Network,0,0,0,0,0,0,0
10K Dex,3,16,7,26,11.538461538461538,61.53846153846154,26.923076923076923
squid,0,0,0,0,0,0,0
GOAT Gaming,0,0,0,0,0,0,0
Hybrid,1,1,0,2,50.0,50.0,0.0
LazyOtter,0,0,0,0,0,0,0
Zerion,0,0,0,0,0,0,0
Chirp,12,7,4,23,52.17391304347826,30.434782608695656,17.391304347826086
Zebra,1,1,0,2,50.0,50.0,0.0
AI Gram,0,0,0,0,0,0,0
Cog Finance,0,0,0,0,0,0,0
StakeStone,0,0,0,0,0,0,0
Mantle,0,0,0,0,0,0,0
Superposition,0,0,0,0,0,0,0
Symmetry Trade,0,0,0,0,0,0,0
Adrena,2,1,0,3,66.66666666666666,33.33333333333333,0.0
Movement,28,14,7,49,57.14285714285714,28.57142857142857,14.285714285714285
NX Finance,0,0,0,0,0,0,0
Superposition Finance,0,0,0,0,0,0,0
ORA,200,123,107,430,46.51162790697674,28.604651162790695,24.88372093023256
GammaSwap,0,0,0,0,0,0,0
Unite,2,2,3,7,28.57142857142857,28.57142857142857,42.857142857142854
Shardeum,0,0,0,0,0,0,0
Echelon,0,0,0,0,0,0,0
Rho Markets,0,0,0,0,0,0,0
Rainbow,63,9,10,82,76.82926829268293,10.975609756097562,12.195121951219512
Zeta,0,0,0,0,0,0,0
Optopia,0,3,0,3,0.0,100.0,0.0
Blast,21,22,75,118,17.796610169491526,18.64406779661017,63.559322033898304
Zeek Network,0,0,0,0,0,0,0
Summer.fi,0,0,0,0,0,0,0
Infinex,0,0,0,0,0,0,0
Mitosis,0,0,0,0,0,0,0
Sophon,0,0,0,0,0,0,0
Voi Network,0,0,0,0,0,0,0
nftperp,0,0,0,0,0,0,0
Hyperlane,0,0,0,0,0,0,0
NURI Exchange,0,0,0,0,0,0,0
f(x) Protocol,0,0,0,0,0,0,0
The Backwoods,6,4,5,15,40.0,26.666666666666668,33.33333333333333
Kinetix Finance,0,0,0,0,0,0,0
Binance,20,8,19,47,42.5531914893617,17.02127659574468,40.42553191489361
LayerZero,0,0,0,0,0,0,0
EigenLayer,1,0,0,1,100.0,0.0,0.0
Vest,232,112,86,430,53.95348837209303,26.046511627906977,20.0
Koi Finance,0,0,0,0,0,0,0
100x,2,0,0,2,100.0,0.0,0.0
DEGEN WAR$,0,0,0,0,0,0,0
Cherry,8,1,0,9,88.88888888888889,11.11111111111111,0.0
Zest Protocol,0,0,0,0,0,0,0
Catalyst,0,5,0,5,0.0,100.0,0.0
Renzo,0,0,0,0,0,0,0
Mercle,2,0,0,2,100.0,0.0,0.0
GriffinAI,0,0,0,0,0,0,0
Captain & Company,0,0,0,0,0,0,0
IoTeX,0,0,0,0,0,0,0
Orderly Network,0,0,0,0,0,0,0
Sui,98,58,29,185,52.972972972972975,31.351351351351354,15.675675675675677
CoChilli,0,0,0,0,0,0,0
Fhenix,0,0,0,0,0,0,0
Avantis,0,0,0,0,0,0,0
deBridge,0,0,0,0,0,0,0
Aethir,0,0,0,0,0,0,0
Glyph,0,0,0,0,0,0,0
0xAstra,0,0,0,0,0,0,0
SOFA,1,2,1,4,25.0,50.0,25.0
ZKsync,53,0,0,53,100.0,0.0,0.0
Taiko,0,0,0,0,0,0,0
Revert,0,0,0,0,0,0,0
Nexis Network,1,0,0,1,100.0,0.0,0.0
Bitflow,0,0,0,0,0,0,0
KIP Protocol,0,0,0,0,0,0,0
Dunes,24,10,3,37,64.86486486486487,27.027027027027028,8.108108108108109
Biokript,0,0,0,0,0,0,0
D8X,1,0,34,35,2.857142857142857,0.0,97.14285714285714
Fuel,6,8,5,19,31.57894736842105,42.10526315789473,26.31578947368421
RIZE,25,4,7,36,69.44444444444444,11.11111111111111,19.444444444444446
Jigsaw,0,1,0,1,0.0,100.0,0.0
Turtle Club,4,0,0,4,100.0,0.0,0.0
Rivo.xyz,0,0,0,0,0,0,0
GM Network,10,9,4,23,43.47826086956522,39.130434782608695,17.391304347826086
Pocket Protector,26,12,10,48,54.166666666666664,25.0,20.833333333333336
Olive Network,0,0,1,1,0.0,0.0,100.0
Zaros,0,0,0,0,0,0,0
Avarik Saga,0,0,0,0,0,0,0
Forma,178,112,73,363,49.03581267217631,30.853994490358126,20.110192837465565
GaiaNet,0,0,0,0,0,0,0
ALIENX,0,0,0,0,0,0,0
Hyperliquid,0,0,0,0,0,0,0
Onchain,5,1,3,9,55.55555555555556,11.11111111111111,33.33333333333333
Syrup,0,0,0,0,0,0,0
Sender Labs,0,0,0,0,0,0,0
Ithaca Protocol,0,0,0,0,0,0,0
Marginly,0,0,0,0,0,0,0
Anichess,0,0,0,0,0,0,0
Equation,3,0,3,6,50.0,0.0,50.0
Quantcheck,0,0,0,0,0,0,0
Nekodex,0,0,0,0,0,0,0
Solayer,1,0,0,1,100.0,0.0,0.0
Fantasy Top,0,0,0,0,0,0,0
Anzen,0,0,0,0,0,0,0
EVAA Protocol,0,0,0,0,0,0,0
Eigenpie,0,0,0,0,0,0,0
Oasis AI,0,0,0,0,0,0,0
Nexo,2,0,0,2,100.0,0.0,0.0
CEX.IO,0,0,0,0,0,0,0
Pencils Protocol,0,0,0,0,0,0,0
Plume Network,0,0,0,0,0,0,0
Cryptopia,4,0,0,4,100.0,0.0,0.0
OpenGPU Network,0,0,0,0,0,0,0
Iskra,0,0,0,0,0,0,0
Lingo,0,0,0,0,0,0,0
Gravita Protocol,0,0,0,0,0,0,0
Initia,65,39,36,140,46.42857142857143,27.857142857142858,25.71428571428571
Token Metrics,0,0,0,0,0,0,0
Gamium,0,0,0,0,0,0,0
Agora,3,1,0,4,75.0,25.0,0.0
Liquidium,0,0,0,0,0,0,0
AutoLayer,0,0,0,0,0,0,0
EtherMail,0,0,0,0,0,0,0
Vooi,0,0,0,0,0,0,0
Lyra,0,0,0,0,0,0,0
tea,343,132,142,617,55.59157212317666,21.39384116693679,23.014586709886547
M2,2,1,1,4,50.0,25.0,25.0
EYWA,0,0,0,0,0,0,0
Delabs Games,0,0,0,0,0,0,0
Dwinity,0,0,0,0,0,0,0
ThetaNuts Finance,0,0,0,0,0,0,0
World PvP,1,0,0,1,100.0,0.0,0.0
Thruster,0,0,0,0,0,0,0
Tari,35,40,18,93,37.634408602150536,43.01075268817204,19.35483870967742
Imaginary Ones,0,0,0,0,0,0,0
Glacier Network,0,0,0,0,0,0,0
Zyfi,0,0,0,0,0,0,0
Storm Trade,0,0,0,0,0,0,0
Phaver,0,0,0,0,0,0,0
Elfin,0,0,0,0,0,0,0
Masa,0,0,0,0,0,0,0
SpaceCatch,0,0,0,0,0,0,0
Mande Network,0,0,0,0,0,0,0
Xtremeverse,0,0,0,0,0,0,0
Fyde,0,0,0,0,0,0,0
Ekubo,0,0,0,0,0,0,0
CAGA,0,0,0,0,0,0,0
Sanctum,0,0,0,0,0,0,0
zkPass,0,0,0,0,0,0,0
My Lovely Planet,0,0,0,0,0,0,0
Tabi,43,37,13,93,46.236559139784944,39.784946236559136,13.978494623655912
Mode,210,100,102,412,50.970873786407765,24.271844660194176,24.75728155339806
Particle Network,0,0,0,0,0,0,0
XSwap,0,0,0,0,0,0,0
ZeroLend,0,0,0,0,0,0,0
Aperture Finance,0,0,0,0,0,0,0
MYTH,10,5,3,18,55.55555555555556,27.77777777777778,16.666666666666664
Immutable,0,0,0,0,0,0,0
Drift Protocol,0,0,0,0,0,0,0
Another-1,0,0,0,0,0,0,0
Raiinmaker,0,0,0,0,0,0,0
Blackwing,0,0,0,0,0,0,0
Kamino,0,0,0,0,0,0,0
Saltwater Games,0,0,0,0,0,0,0
UpRock,0,0,0,0,0,0,0
LunarStorm,0,0,0,0,0,0,0
Revolving Games,0,0,0,0,0,0,0
PlanetQuest,0,0,0,0,0,0,0
Zoth,0,0,0,0,0,0,0
IntentX,0,0,0,0,0,0,0
BeFi Labs,0,0,0,0,0,0,0
Reya Network,0,0,0,0,0,0,0
Moongate,0,0,0,0,0,0,0
Pixelverse,0,0,0,0,0,0,0
Apillon,0,0,0,0,0,0,0
Bemo,0,0,0,0,0,0,0
MilkyWay,2,0,0,2,100.0,0.0,0.0
Astaria,0,0,0,0,0,0,0
BSX,0,0,0,0,0,0,0
OrangeLayer,0,0,0,0,0,0,0
InceptionLRT,0,0,0,0,0,0,0
MANTRA,0,0,0,0,0,0,0
BounceBit,0,0,0,0,0,0,0
BlastOff,0,0,0,0,0,0,0
Soarchain,0,0,0,0,0,0,0
Elixir,0,0,0,0,0,0,0
Omni Network,0,0,0,0,0,0,0
Solv Protocol,0,0,0,0,0,0,0
Planet Mojo,0,0,0,0,0,0,0
Parcl,0,0,0,0,0,0,0
DTX,0,0,0,0,0,0,0
Ultimate Digits,0,0,0,0,0,0,0
MPRO Lab,0,0,0,0,0,0,0
Tensor,0,0,0,0,0,0,0
Pac Finance,0,0,0,0,0,0,0
OverTrip,0,0,0,0,0,0,0
BlockGames,0,0,0,0,0,0,0
Warden Protocol,0,0,0,0,0,0,0
Base Name Service,0,0,0,0,0,0,0
Scallop,0,0,0,0,0,0,0
SynFutures,0,0,0,0,0,0,0
StarryNift,0,0,0,0,0,0,0
Wormhole,0,0,0,0,0,0,0
Hava Coin,0,0,0,0,0,0,0
Battle Showdown: Gambit,0,0,0,0,0,0,0
Ethena,0,0,0,0,0,0,0
Data Ownership Protocol,0,0,0,0,0,0,0
Pryzm,0,0,0,0,0,0,0
COTI,22,33,0,55,40.0,60.0,0.0
A51,0,0,0,0,0,0,0
ZKE Exchange,0,0,0,0,0,0,0
Sharpe,7,7,2,16,43.75,43.75,12.5
Aries Markets,0,0,0,0,0,0,0
Elys Network,0,0,0,0,0,0,0
Haven1,0,0,0,0,0,0,0
Helix,18,8,6,32,56.25,25.0,18.75
Kelp DAO,0,0,0,0,0,0,0
mySwap,0,0,0,0,0,0,0
Braavos,0,0,0,0,0,0,0
Tortuga Finance,0,0,0,0,0,0,0
BNB Chain,2,1,1,4,50.0,25.0,25.0
Aptin Finance,0,0,0,0,0,0,0
UniRouter,0,0,0,0,0,0,0
Bitget Wallet,0,0,0,0,0,0,0
Aptos,0,0,0,0,0,0,0
beoble,0,0,0,0,0,0,0
Param Gaming,0,0,0,0,0,0,0
XYRO,0,0,0,0,0,0,0
Plena,0,0,0,0,0,0,0
Polyhedra Network,0,0,0,0,0,0,0
DFlow,0,0,0,0,0,0,0
zkLend,0,0,0,0,0,0,0
Defispot,0,0,0,0,0,0,0
Boson Protocol,0,0,0,0,0,0,0
Metis,0,0,0,0,0,0,0
DistrictOne,0,0,0,0,0,0,0
Layer3,0,0,0,0,0,0,0
Entangle,9,6,6,21,42.857142857142854,28.57142857142857,28.57142857142857
Panther Protocol,0,0,0,0,0,0,0
Memecoin,3,0,0,3,100.0,0.0,0.0
Teller,2,2,0,4,50.0,50.0,0.0
Gomble Games,0,0,0,0,0,0,0
Parallel Network,0,0,0,0,0,0,0
Venom,10,5,0,15,66.66666666666666,33.33333333333333,0.0
SYNTHR,0,0,0,0,0,0,0
Wen Exchange,0,0,0,0,0,0,0
YOLO Games,0,0,0,0,0,0,0
Lava,3,2,1,6,50.0,33.33333333333333,16.666666666666664
InvArch,0,0,0,0,0,0,0
KiloEx,0,0,0,0,0,0,0
Hana Network,0,0,0,0,0,0,0
MetaStreet,0,0,0,0,0,0,0
NuLink,0,0,0,0,0,0,0
Ambit Finance,0,0,0,0,0,0,0
Smart Layer,0,0,0,0,0,0,0
MON Protocol,0,0,0,0,0,0,0
Rio Network,0,0,0,0,0,0,0
Optimism,0,3,0,3,0.0,100.0,0.0
Blaster,0,0,0,0,0,0,0
StarkNet,2,0,0,2,100.0,0.0,0.0
AltLayer,0,0,0,0,0,0,0
Pixels,3,1,0,4,75.0,25.0,0.0
Aftermath Finance,0,0,0,0,0,0,0
AVNU,0,0,0,0,0,0,0
Bluefin,0,0,0,0,0,0,0
Overlay Protocol,0,0,0,0,0,0,0
ClayStack,0,0,0,0,0,0,0
Retro Bridge,0,0,0,0,0,0,0
Dymension,0,0,0,0,0,0,0
INIT Capital,0,0,0,0,0,0,0
BÂ² Network,0,0,0,0,0,0,0
Pike,3,7,0,10,30.0,70.0,0.0
ZetaChain,0,0,0,0,0,0,0
Partisia Blockchain,0,0,0,0,0,0,0
Aether,0,0,0,0,0,0,0
Nostra,0,0,0,0,0,0,0
edeXa,0,0,0,0,0,0,0
Undeads,0,0,0,0,0,0,0
Aether Games,0,0,0,0,0,0,0
Dmail Network,0,0,0,0,0,0,0
Presearch,0,0,0,0,0,0,0
Bitcoin Virtual Machine,0,0,0,0,0,0,0
StackingDAO,0,0,0,0,0,0,0
NAVI Protocol,0,0,0,0,0,0,0
Mind Network,0,0,0,0,0,0,0
XION,0,0,0,0,0,0,0
Ready To Fight,0,0,0,0,0,0,0
BRC-20 DEX,0,0,0,0,0,0,0
Web3Go,0,0,0,0,0,0,0
eesee,0,0,0,0,0,0,0
Unigraph Protocol,0,0,0,0,0,0,0
Virtual Labs,0,0,0,0,0,0,0
Manta Network,0,0,0,0,0,0,0
Sound.xyz,0,0,0,0,0,0,0
Reveel,0,0,0,0,0,0,0
CARV,11,3,0,14,78.57142857142857,21.428571428571427,0.0
Swell,2,2,1,5,40.0,40.0,20.0
Frame,34,11,3,48,70.83333333333334,22.916666666666664,6.25
TeleportDAO,0,0,0,0,0,0,0
Seamless Protocol,0,0,0,0,0,0,0
BRC20,0,0,0,0,0,0,0
Kinza Finance,0,0,0,0,0,0,0
Elusiv,0,0,0,0,0,0,0
Marinade,0,0,0,0,0,0,0
Jito,0,0,0,0,0,0,0
Term Structure,0,0,0,0,0,0,0
Hinkal,0,0,0,0,0,0,0
Patex,0,0,0,0,0,0,0
Pyth Network,4,0,0,4,100.0,0.0,0.0
Meuna,0,0,0,0,0,0,0
Satori,0,0,0,0,0,0,0
marginfi,0,0,0,0,0,0,0
Scroll Name Service,0,0,0,0,0,0,0
Aori,5,0,0,5,100.0,0.0,0.0
GRVT,0,0,0,0,0,0,0
ShanHai,0,0,0,0,0,0,0
Tezos Domains,0,0,0,0,0,0,0
Derivio,0,0,0,0,0,0,0
Celestia,1,0,0,1,100.0,0.0,0.0
BlueLight,0,0,0,0,0,0,0
Forcefi,0,0,0,0,0,0,0
Juice,0,0,0,0,0,0,0
Karak,1,0,0,1,100.0,0.0,0.0
RedStone,2,1,4,7,28.57142857142857,14.285714285714285,57.14285714285714
OKX,3,1,0,4,75.0,25.0,0.0
Mangrove,0,0,0,0,0,0,0
Altitude,0,0,0,0,0,0,0
Ambient,1,0,0,1,100.0,0.0,0.0
Connext,0,0,0,0,0,0,0
Okto x QuickSwap,0,0,0,0,0,0,0
Clipper,0,0,0,0,0,0,0
MoonlandMeta,0,0,0,0,0,0,0
Basilisk,0,0,0,0,0,0,0
Lightlink,0,0,0,0,0,0,0
Extra Finance,0,0,0,0,0,0,0
Chainflip,0,0,0,0,0,0,0
Web3Eco,0,0,0,0,0,0,0
Hubble Exchange,0,0,0,0,0,0,0
HMX,0,0,0,0,0,0,0
MELD,0,0,0,0,0,0,0
Worldcoin,0,0,0,0,0,0,0
DX25,0,0,0,0,0,0,0
Tsunami Finance,0,0,0,0,0,0,0
TapiocaDAO,0,0,0,0,0,0,0
Archway,0,0,0,0,0,0,0
zkSync id,0,0,0,0,0,0,0
Polygon zkEVM,0,0,0,0,0,0,0
Diva,0,0,0,0,0,0,0
Vela Exchange,0,0,0,0,0,0,0
Letit,0,0,0,0,0,0,0
WhiteBIT,0,0,0,0,0,0,0
Maverick Protocol,0,0,0,0,0,0,0
Tevaera,0,0,0,0,0,0,0
Velar,0,0,0,0,0,0,0
LunaFi,0,0,0,0,0,0,0
DBOE,0,0,0,0,0,0,0
Range Protocol,0,0,0,0,0,0,0
Cedro Finance,0,0,0,0,0,0,0
DigiFinex,0,0,0,0,0,0,0
BYDFi,0,0,0,0,0,0,0
Magic Square,0,0,0,0,0,0,0
StarkNet ID,0,0,0,0,0,0,0
Aark Digital,0,0,0,0,0,0,0
MUFEX,0,0,0,0,0,0,0
Foxify,0,0,0,0,0,0,0
PulseChain,0,0,0,0,0,0,0
Housebets.io,0,0,0,0,0,0,0
DexCheck,0,0,0,0,0,0,0
Rebel Bots,0,0,0,0,0,0,0
Hord,3,1,0,4,75.0,25.0,0.0
Cashmere,0,0,0,0,0,0,0
5ireChain,0,0,0,0,0,0,0
zkSync Name Service,0,0,0,0,0,0,0
Yum Yum,0,0,0,0,0,0,0
ZKX,0,0,0,0,0,0,0
Increment,1,0,0,1,100.0,0.0,0.0
The Lost Wallet,0,0,0,0,0,0,0
Linea,9,12,4,25,36.0,48.0,16.0
Polynomial Protocol,0,0,0,0,0,0,0
SyncSwap,1,0,0,1,100.0,0.0,0.0
Daoversal,0,0,0,0,0,0,0
Velvet.Capital,0,0,0,0,0,0,0
Huma Finance,0,0,0,0,0,0,0
SnowCone,0,0,0,0,0,0,0
Arbitrum,4,0,0,4,100.0,0.0,0.0
Quasar,0,0,0,0,0,0,0
Dune Analytics,0,0,0,0,0,0,0
SPACE ID,0,0,0,0,0,0,0
Legends of Elysium,0,0,0,0,0,0,0
Tide Exchange,0,0,0,0,0,0,0
AlienSwap,0,0,0,0,0,0,0
ZigZag,0,0,0,0,0,0,0
Collab.Land,0,0,0,0,0,0,0
Nexon Finance,0,0,0,0,0,0,0
EZ Finance,0,0,0,0,0,0,0
Olive,13,4,5,22,59.09090909090909,18.181818181818183,22.727272727272727
Enchanter Finance,0,0,0,0,0,0,0
Mayan,0,0,0,0,0,0,0
Sudoswap,0,0,0,0,0,0,0
Timeless,0,0,0,0,0,0,0
BillionAir,3,1,0,4,75.0,25.0,0.0
SupraOracles,0,0,0,0,0,0,0
IPOR,0,0,0,0,0,0,0
Neptune Mutual,0,0,0,0,0,0,0
NFT3,0,0,0,0,0,0,0
Demex,0,0,0,0,0,0,0
Specular,0,0,0,0,0,0,0
Hashstack,0,0,0,0,0,0,0
Brine,0,0,0,0,0,0,0
V2X,0,0,0,0,0,0,0
Supernova,0,0,0,0,0,0,0
Bebop,0,0,0,0,0,0,0
KwikTrust,0,0,0,0,0,0,0
Phi,102,31,59,192,53.125,16.145833333333336,30.729166666666668
Plenty,33,13,17,63,52.38095238095239,20.634920634920633,26.984126984126984
Swing,12,0,2,14,85.71428571428571,0.0,14.285714285714285
Spectrum Finance,0,0,0,0,0,0,0
Harbor Protocol,0,0,0,0,0,0,0
Sentiment,18,16,3,37,48.64864864864865,43.24324324324324,8.108108108108109
Vertex,0,0,0,0,0,0,0
Voltz,0,0,0,0,0,0,0
objkt.com,0,0,0,0,0,0,0
TiTi Protocol,0,0,0,0,0,0,0
JediSwap,0,0,0,0,0,0,0
Uniswap,1,0,1,2,50.0,0.0,50.0
Across,56,24,18,98,57.14285714285714,24.489795918367346,18.367346938775512
Mean Finance,0,0,0,0,0,0,0
Key App,0,0,0,0,0,0,0
ParaSpace,0,0,0,0,0,0,0
Layerswap,0,0,0,0,0,0,0
Aboard,0,1,0,1,0.0,100.0,0.0
MUN,223,58,142,423,52.71867612293144,13.711583924349883,33.56973995271868
Via Protocol,0,0,0,0,0,0,0
ChainHop,0,0,0,0,0,0,0
Cega,0,0,0,0,0,0,0
Wombat,0,1,0,1,0.0,100.0,0.0
MTG,8,36,7,51,15.686274509803921,70.58823529411765,13.725490196078432
Arrakis Finance,0,0,0,0,0,0,0
Dolomite,0,0,0,0,0,0,0
Deepwaters,0,0,0,0,0,0,0
BlueMove,0,0,0,0,0,0,0
OptiFi,0,0,0,0,0,0,0
Alpha Road,0,0,0,0,0,0,0
Sei,9,6,3,18,50.0,33.33333333333333,16.666666666666664
OpenChat,2,0,0,2,100.0,0.0,0.0
RabbitX,0,0,0,0,0,0,0
The Granary,0,0,0,0,0,0,0
Metaplex,0,0,0,0,0,0,0
Tectum,0,0,0,0,0,0,0
Onomy Protocol,0,0,0,0,0,0,0
Blur,12,17,3,32,37.5,53.125,9.375
Trustless,2,1,0,3,66.66666666666666,33.33333333333333,0.0
Verida,0,0,0,0,0,0,0
Xai,2,0,0,2,100.0,0.0,0.0
Commodo,0,0,0,0,0,0,0
Stratos,0,0,0,0,0,0,0
Teritori,0,0,0,0,0,0,0
XEN Crypto,0,0,0,0,0,0,0
Binance Account Bound (BAB),0,0,0,0,0,0,0
ZKEX,0,0,0,0,0,0,0
Helio Protocol,2,1,1,4,50.0,25.0,25.0
Karate Combat,0,0,0,0,0,0,0
Conic Finance,0,0,0,0,0,0,0
HTX,16,3,0,19,84.21052631578947,15.789473684210526,0.0
Odos,0,0,0,0,0,0,0
Ragnar Protocol,0,0,0,0,0,0,0
AllStars Digital,0,0,0,0,0,0,0
KuCoin,3,1,0,4,75.0,25.0,0.0
Xiroverse,0,0,0,0,0,0,0
Terran Coin,0,0,0,0,0,0,0
Quai Network,0,0,0,0,0,0,0
Dogechain,0,0,0,0,0,0,0
Portal,7,5,3,15,46.666666666666664,33.33333333333333,20.0
Cornerstone,0,0,0,0,0,0,0
Stride,0,0,0,0,0,0,0
Composable Finance,0,0,0,0,0,0,0
STRMNFT,0,0,0,0,0,0,0
Tegro,0,0,0,0,0,0,0
Quix,0,0,0,0,0,0,0
Bungee,0,0,0,0,0,0,0
StormGain,0,0,0,0,0,0,0
Primex,0,0,0,0,0,0,0
Tally Ho,0,0,0,0,0,0,0
Forta,29,13,7,49,59.183673469387756,26.53061224489796,14.285714285714285
Sweat Economy,0,0,0,0,0,0,0
ZORA,0,0,0,0,0,0,0
Velodrome,0,0,0,0,0,0,0
Chains,35,16,23,74,47.2972972972973,21.62162162162162,31.08108108108108
0VIX,0,0,0,0,0,0,0
Bonq,0,0,0,0,0,0,0
Epsylon,0,0,0,0,0,0,0
Ledn,0,0,0,0,0,0,0
RealMe,0,0,0,0,0,0,0
Matrix,1,2,0,3,33.33333333333333,66.66666666666666,0.0
Retrograde,0,0,0,0,0,0,0
Hop Protocol,0,0,0,0,0,0,0
Gem,80,56,43,179,44.6927374301676,31.28491620111732,24.022346368715084
Lend Flare,0,0,0,0,0,0,0
Armaldia,0,0,0,0,0,0,0
Leap Wallet,0,0,0,0,0,0,0
Bridgesplit,0,0,0,0,0,0,0
Fractional,4,1,1,6,66.66666666666666,16.666666666666664,16.666666666666664
Nebula Protocol,0,0,0,0,0,0,0
Orbofi,0,0,0,0,0,0,0
Styllar,0,0,0,0,0,0,0
Crescent Network,0,0,0,0,0,0,0
Tangible,4,9,0,13,30.76923076923077,69.23076923076923,0.0
Taki,145,68,67,280,51.78571428571429,24.285714285714285,23.92857142857143
ioTube,0,0,0,0,0,0,0
YoBit,0,0,0,0,0,0,0
Void Protocol,0,0,0,0,0,0,0
VINCI,2,0,3,5,40.0,0.0,60.0
Element Finance,0,0,0,0,0,0,0
LandDAO,0,0,0,0,0,0,0
cheqd,0,0,0,0,0,0,0
DAO Labs,0,0,0,0,0,0,0
Unagii,0,0,0,0,0,0,0
Nested,4,2,1,7,57.14285714285714,28.57142857142857,14.285714285714285
AssetMantle,0,0,0,0,0,0,0
Morpher,0,0,0,0,0,0,0
LimeWire,0,0,0,0,0,0,0
Mars Protocol,0,0,0,0,0,0,0
Findora,0,0,0,0,0,0,0
LikeCoin,0,0,0,0,0,0,0
Fuji DAO,0,0,0,0,0,0,0
Diffusion Finance,0,0,0,0,0,0,0
pSTAKE Finance,0,0,0,0,0,0,0
PartyBid,0,0,0,0,0,0,0
Frax,0,0,0,0,0,0,0
Craft Economy,0,0,0,0,0,0,0
X2Y2,0,0,0,0,0,0,0
CowSwap,0,0,0,0,0,0,0
Orbiter Finance,0,9,0,9,0.0,100.0,0.0
GameInfinity,0,0,0,0,0,0,0
Katana,9,3,3,15,60.0,20.0,20.0
Stargaze,0,0,0,0,0,0,0
Trust Domains,0,0,0,0,0,0,0
Fraktal,0,0,0,0,0,0,0
Votium,0,0,0,0,0,0,0
Pika Protocol,0,0,0,0,0,0,0
Nomic,80,76,36,192,41.66666666666667,39.58333333333333,18.75
Friktion,0,0,0,0,0,0,0
WhaleFin,0,0,0,0,0,0,0
Sonic,7,6,1,14,50.0,42.857142857142854,7.142857142857142
Quarry,6,0,0,6,100.0,0.0,0.0
OmniFlix,0,0,0,0,0,0,0
Chic Cow & Bullzz,0,0,0,0,0,0,0
Shell Protocol,0,0,0,0,0,0,0
Mintbase,0,0,0,0,0,0,0
Legion Network,0,0,0,0,0,0,0
Rubicon,0,0,0,0,0,0,0
Glow,3,4,1,8,37.5,50.0,12.5
Coinhall,0,0,0,0,0,0,0
LooksRare,0,0,0,0,0,0,0
StellarX,0,0,0,0,0,0,0
Coreum,0,0,0,0,0,0,0
Gas DAO,0,0,0,0,0,0,0
Astroport,0,0,0,0,0,0,0
Aztec,0,0,0,0,0,0,0
Terra Name Service,0,0,0,0,0,0,0
Lum Network,0,0,0,0,0,0,0
Francium,0,0,0,0,0,0,0
ICON,5,4,20,29,17.24137931034483,13.793103448275861,68.96551724137932
Paras,0,0,0,0,0,0,0
IOTA,0,0,0,0,0,0,0
Comdex,1,0,0,1,100.0,0.0,0.0
Volmex,0,0,0,0,0,0,0
iExec,0,0,0,0,0,0,0
Berachain,0,0,0,0,0,0,0
Die Last,0,0,0,0,0,0,0
Rabby Wallet,0,0,0,0,0,0,0
Grindery,1,1,4,6,16.666666666666664,16.666666666666664,66.66666666666666
Synonym,0,1,0,1,0.0,100.0,0.0
Terra World,0,0,0,0,0,0,0
Superfluid,0,0,0,0,0,0,0
Hardcore FC,0,0,0,0,0,0,0
Hedgehog Markets,0,0,0,0,0,0,0
Sablier,0,0,0,0,0,0,0
Desmos,0,0,0,0,0,0,0
Atrix,1,2,0,3,33.33333333333333,66.66666666666666,0.0
Instrumental Finance,0,0,0,0,0,0,0
TokenSets,0,0,0,0,0,0,0
Spintop,0,0,0,0,0,0,0
Phantom,1,6,0,7,14.285714285714285,85.71428571428571,0.0
Aquarius,0,0,0,0,0,0,0
Saddle Finance,0,0,0,0,0,0,0
DexGuru,0,0,0,0,0,0,0
ParaSwap,0,0,0,0,0,0,0
Matcha,0,0,0,0,0,0,0
Solanart,0,0,0,0,0,0,0
Foundation,10,11,6,27,37.03703703703704,40.74074074074074,22.22222222222222
Digital Arms,0,0,0,0,0,0,0
Gro Protocol,0,0,0,0,0,0,0
Gridlock,0,0,0,0,0,0,0
Paladin,10,3,3,16,62.5,18.75,18.75
Apricot Finance,0,0,0,0,0,0,0
Sologenic,0,0,0,0,0,0,0
TerraFloki,0,0,0,0,0,0,0
DeFi Saver,0,0,0,0,0,0,0
OneOf,0,0,0,0,0,0,0
BitYard,0,0,0,0,0,0,0
Zapper,0,0,0,0,0,0,0
HUMAN Protocol,0,0,0,0,0,0,0
Gaia EverWorld,0,0,0,0,0,0,0
Sportemon Go,0,0,0,0,0,0,0
Yield Protocol,0,0,0,0,0,0,0
Cozy Finance,0,0,0,0,0,0,0
Timeswap,0,0,0,0,0,0,0
Terra Land,0,0,0,0,0,0,0
Opyn,0,0,0,0,0,0,0
Symmetry,5,1,0,6,83.33333333333334,16.666666666666664,0.0
Apollo DAO,0,0,0,0,0,0,0
Solend,0,0,0,0,0,0,0
Terraswap,0,0,0,0,0,0,0
Talis Protocol,0,0,0,0,0,0,0
Flare Finance,0,0,0,0,0,0,0
Polymarket,0,0,0,0,0,0,0
Valkyrie Protocol,0,0,0,0,0,0,0
Slingshot,0,0,0,0,0,0,0
OpenSea,0,0,0,0,0,0,0
Shade Protocol,0,0,0,0,0,0,0
Roco Finance,0,0,0,0,0,0,0
Backd,2,3,0,5,40.0,60.0,0.0
Loop,33,1,15,49,67.3469387755102,2.0408163265306123,30.612244897959183
Metamask,9,12,6,27,33.33333333333333,44.44444444444444,22.22222222222222
Nexus Protocol,0,0,0,0,0,0,0
Boba Network,0,0,0,0,0,0,0
Portuma,0,0,0,0,0,0,0
BrightID,0,0,0,0,0,0,0
InPoker,0,0,0,0,0,0,0
Adshares,0,0,0,0,0,0,0
Thales,0,0,0,0,0,0,0
Foil Network,0,0,0,0,0,0,0
Songbird,0,0,0,0,0,0,0
Tokel,0,0,0,0,0,0,0
BullionFX,0,0,0,0,0,0,0
Juno,6,0,0,6,100.0,0.0,0.0
Bitget,0,0,0,0,0,0,0
Remitano,0,0,0,0,0,0,0
Angel Protocol,0,0,0,0,0,0,0
StarTerra,0,0,0,0,0,0,0
Blockasset,0,0,0,0,0,0,0
SuperRare,0,0,0,0,0,0,0
HAI DAMO,0,0,0,0,0,0,0
Sunny,0,0,0,0,0,0,0
WEYU,0,0,0,0,0,0,0
dYdX,0,0,0,0,0,0,0
DFyn,0,0,0,0,0,0,0
Notional,0,0,0,0,0,0,0
Altair,0,0,0,0,0,0,0
ShapeShift,0,0,0,0,0,0,0
THORSwap,0,0,0,0,0,0,0
VoltNFT,0,0,0,0,0,0,0
OpenOcean,0,0,0,0,0,0,0
NFTb,0,0,0,0,0,0,0
hi,2860,1161,1195,5216,54.831288343558285,22.258435582822088,22.91027607361963
TAP,26,15,13,54,48.148148148148145,27.77777777777778,24.074074074074073
Moonbet,0,0,0,0,0,0,0
Spar Finance,0,0,0,0,0,0,0
Connect Financial,0,0,0,0,0,0,0
Osmosis,3,0,0,3,100.0,0.0,0.0
Pylon Protocol,0,0,0,0,0,0,0
GemBites,0,0,0,0,0,0,0
EarnBet,1,0,1,2,50.0,0.0,50.0
Orion Money,0,0,0,0,0,0,0
Omni,4,8,1,13,30.76923076923077,61.53846153846154,7.6923076923076925
EmiSwap,0,0,0,0,0,0,0
CRD Network,0,0,0,0,0,0,0
Instadapp,0,0,0,0,0,0,0
Degenâs Farm,0,0,0,0,0,0,0
Blockster,0,0,0,0,0,0,0
Skyward Finance,0,0,0,0,0,0,0
MoonEdge,0,0,0,0,0,0,0
NEFTiPEDiA,0,0,0,0,0,0,0
Thorstarter,0,0,0,0,0,0,0
Arweave,0,0,0,0,0,0,0
APENFT,0,0,0,0,0,0,0
EasyBake,0,0,0,0,0,0,0
Honeyswap,0,0,0,0,0,0,0
Charged Particles,0,0,0,0,0,0,0
BarterTrade,0,0,0,0,0,0,0
Ribbon Finance,0,0,0,0,0,0,0
ZoidPay,1,0,0,1,100.0,0.0,0.0
QiSwap,0,0,0,0,0,0,0
Crypto Thrills,0,0,0,0,0,0,0
DoRen,0,0,0,0,0,0,0
SolPAD,0,0,0,0,0,0,0
Convex Finance,0,0,0,0,0,0,0
RunNode,0,0,0,0,0,0,0
Venus,0,0,0,0,0,0,0
ChainX,0,0,0,0,0,0,0
Revuto,0,0,0,0,0,0,0
Solanium,0,0,0,0,0,0,0
Impermax Finance,0,0,0,0,0,0,0
Avalaunch,0,0,0,0,0,0,0
Etherlite,0,0,0,0,0,0,0
Badger DAO,0,0,0,0,0,0,0
DeversiFi,0,0,0,0,0,0,0
Bribe,2,0,0,2,100.0,0.0,0.0
SORA,0,0,0,0,0,0,0
Maiar Exchange,0,0,0,0,0,0,0
HOPR,0,0,0,0,0,0,0
Aladdin,1,0,0,1,100.0,0.0,0.0
KLOMP,0,0,0,0,0,0,0
NFTMart,0,0,0,0,0,0,0
LOTTO,0,0,0,0,0,0,0
1inch,0,0,0,0,0,0,0
Affine,0,0,0,0,0,0,0
NovaDEX,0,0,0,0,0,0,0
Futureverse,0,0,0,0,0,0,0
Script Network,0,0,0,0,0,0,0
Secret Network,0,0,0,0,0,0,0
Hydra,1,17,1,19,5.263157894736842,89.47368421052632,5.263157894736842
My Lotto Coin,0,0,0,0,0,0,0
Anchor Protocol,0,0,0,0,0,0,0
Graphene,0,0,0,0,0,0,0
Utile Network,0,0,0,0,0,0,0
Donnie Finance,0,0,0,0,0,0,0
Sperax,0,0,0,0,0,0,0
PoolTogether,0,0,0,0,0,0,0
Sifchain,0,0,0,0,0,0,0
Neutrino Protocol,0,0,0,0,0,0,0
Bounce,2,3,5,10,20.0,30.0,50.0
Invest & Hodl,0,0,0,0,0,0,0
Furucombo,0,0,0,0,0,0,0
Lido,0,0,0,0,0,0,0
Chainge,0,0,0,0,0,0,0
OnX Finance,0,0,0,0,0,0,0
MarcoPolo Protocol,0,0,0,0,0,0,0
Phala Network,0,0,0,0,0,0,0
Mirror Protocol,0,0,0,0,0,0,0
Numio,0,0,0,0,0,0,0
Flare,1,0,0,1,100.0,0.0,0.0
SocialGood,0,0,0,0,0,0,0
Metex,0,0,0,0,0,0,0
TomoChain,0,0,0,0,0,0,0
Audius,0,0,0,0,0,0,0
SwanFinance,0,0,0,0,0,0,0
Plutus,1,0,0,1,100.0,0.0,0.0
DIA,198,112,139,449,44.097995545657014,24.94432071269488,30.957683741648108
Permission,5,7,6,18,27.77777777777778,38.88888888888889,33.33333333333333
Massnet,0,0,0,0,0,0,0
Symbol,11,8,1,20,55.00000000000001,40.0,5.0
Bitcoin Rhodium,0,0,0,0,0,0,0
Intexcoin,0,0,0,0,0,0,0
GoodDollar,0,0,0,0,0,0,0
ARCS,1,4,0,5,20.0,80.0,0.0
DeFiChain,0,0,0,0,0,0,0
Cypherium,0,0,0,0,0,0,0
Handshake,0,0,0,0,0,0,0
Pcash,0,0,0,0,0,0,0
SwissBorg,0,0,0,0,0,0,0
UniWorld,0,0,0,0,0,0,0
BABB,1,0,0,1,100.0,0.0,0.0
Bitribe,0,0,0,0,0,0,0
NowEx,0,0,0,0,0,0,0
DAO Maker,0,0,0,0,0,0,0
Escher,0,0,0,0,0,0,0
Bitbns,0,0,0,0,0,0,0
Ludena Protocol,0,0,0,0,0,0,0
PointPay,0,0,0,0,0,0,0
JUST,1048,477,484,2009,52.16525634644101,23.743155798904926,24.091587854654055
Relictum Pro,0,0,0,0,0,0,0
Storeum,0,0,0,0,0,0,0
StellarPayGlobal,0,0,0,0,0,0,0
DRK DeFi,0,0,0,0,0,0,0
Two Prime,0,0,0,0,0,0,0
PAC Global,0,0,0,0,0,0,0
FunderOne,0,0,0,0,0,0,0
Azbi,0,0,0,0,0,0,0
Storex,0,0,0,0,0,0,0
Blockpass,0,0,0,0,0,0,0
XinFin,0,0,0,0,0,0,0
1xBit,0,0,0,0,0,0,0
VNT Chain Labs,0,0,0,0,0,0,0
ICURY,0,0,0,0,0,0,0
Swapzone,0,0,0,0,0,0,0
Tandem,3,0,0,3,100.0,0.0,0.0
JDX,0,0,0,0,0,0,0
Global Gaming,0,0,0,0,0,0,0
Foodecent,0,0,0,0,0,0,0
NokNok,0,0,0,0,0,0,0
Minereum,0,0,0,0,0,0,0
Unochain,0,0,0,0,0,0,0
Social Club Rocks,0,0,0,0,0,0,0
KULAP,0,0,0,0,0,0,0
Petro,5,0,0,5,100.0,0.0,0.0
B One Payment,0,0,0,0,0,0,0
Personal Wager,0,0,0,0,0,0,0
Coalculus,0,0,0,0,0,0,0
Beldex,0,0,0,0,0,0,0
DAIN,0,0,0,0,0,0,0
Emirex,0,0,0,0,0,0,0
Bitcoin Turbo Koin Giveaway,0,0,0,0,0,0,0
Bancor,2,0,3,5,40.0,0.0,60.0
JIL TOKENS,0,0,0,0,0,0,0
K-Tune,0,0,0,0,0,0,0
ecxx,0,0,0,0,0,0,0
Pockero,0,0,0,0,0,0,0
Netspot Solutions,0,0,0,0,0,0,0
Limestone Network,0,0,0,0,0,0,0
P2P Club,0,0,0,0,0,0,0
BitCollar,0,0,0,0,0,0,0
Lino Network,0,0,0,0,0,0,0
Brave New Coin,0,0,0,0,0,0,0
Wavesbet,0,0,0,0,0,0,0
Riwigo,0,0,0,0,0,0,0
LiquidApps,0,0,0,0,0,0,0
HeroCoin,0,0,0,0,0,0,0
BlocBox,0,0,0,0,0,0,0
Morpheus Network,0,0,0,0,0,0,0
Neo Smart Energy,0,0,0,0,0,0,0
Stan World,0,0,0,0,0,0,0
Tune.fm,0,0,0,0,0,0,0
Swiftex,0,0,0,0,0,0,0
Diagon,0,0,0,0,0,0,0
ReFork,0,0,0,0,0,0,0
Apollo,1,4,1,6,16.666666666666664,66.66666666666666,16.666666666666664
Cryptocells,0,0,0,0,0,0,0
Freelanex,0,0,0,0,0,0,0
Beowulf Blockchain,0,0,0,0,0,0,0
FreedomOptions,0,0,0,0,0,0,0
2Key,0,0,0,0,0,0,0
Crypto Tribunal,0,0,0,0,0,0,0
TroyTrade,0,0,0,0,0,0,0
KAPPI,0,0,0,0,0,0,0
Kuvacash,0,0,0,0,0,0,0
ENOD,0,0,0,0,0,0,0
CUDOS,0,0,0,0,0,0,0
BitQuant,0,0,0,0,0,0,0
Binance JEX,0,0,0,0,0,0,0
Yezcoin,0,0,0,0,0,0,0
Validity,1,0,0,1,100.0,0.0,0.0
RIF,71,29,40,140,50.71428571428571,20.714285714285715,28.57142857142857
MediLiVes,0,0,0,0,0,0,0
Ormeus Ecosystem,0,0,0,0,0,0,0
INMINING,0,0,0,0,0,0,0
NOS Initiative,0,0,0,0,0,0,0
Maecenas,0,0,0,0,0,0,0
Nova Mining,0,0,0,0,0,0,0
Project WITH,15,6,0,21,71.42857142857143,28.57142857142857,0.0
Adrenaline AI,0,0,0,0,0,0,0
Hydro,9,2,0,11,81.81818181818183,18.181818181818183,0.0
OilWellCoin,0,0,0,0,0,0,0
Pynk,0,0,0,0,0,0,0
GCOX,0,0,0,0,0,0,0
Cocos BCX,0,0,0,0,0,0,0
Livetree,2,0,0,2,100.0,0.0,0.0
Felixo,0,0,0,0,0,0,0
WINk,0,0,0,0,0,0,0
TeleCoin,0,0,0,0,0,0,0
SpockChain,0,0,0,0,0,0,0
Arena Match,0,0,0,0,0,0,0
Discodery,0,0,0,0,0,0,0
Qtum,0,0,0,0,0,0,0
Netkoin,0,0,0,0,0,0,0
Algorand,4,0,1,5,80.0,0.0,20.0
Ten Billion Coin,0,0,0,0,0,0,0
OVR,2,1,0,3,66.66666666666666,33.33333333333333,0.0
BAGS token,0,0,0,0,0,0,0
AllForCrypto,0,0,0,0,0,0,0
Civic,0,0,0,0,0,0,0
Komodo,0,0,0,0,0,0,0
Netbox.Global,0,0,0,0,0,0,0
BRIKCOIN,0,0,0,0,0,0,0
PIEXGO,0,0,0,0,0,0,0
ParamountDax,0,0,0,0,0,0,0
Mediacoin,0,0,0,0,0,0,0
Dusk Network,0,0,0,0,0,0,0
Counos Platform,0,0,0,0,0,0,0
BTCOW,0,0,0,0,0,0,0
FIO Social,0,0,0,0,0,0,0
PBET,0,0,0,0,0,0,0
COINCOME,0,0,0,0,0,0,0
Comno Network,0,0,0,0,0,0,0
Blaze Protocol,0,0,0,0,0,0,0
Genesis,1,5,0,6,16.666666666666664,83.33333333333334,0.0
DocTailor,0,0,0,0,0,0,0
Fortem Capital,0,0,0,0,0,0,0
Authoreon,0,0,0,0,0,0,0
IdeaFeX,0,0,0,0,0,0,0
Ubrica,1,0,0,1,100.0,0.0,0.0
Typerium,0,0,0,0,0,0,0
VCC Exchange,0,0,0,0,0,0,0
Product Protocol,0,0,0,0,0,0,0
ETHplode,0,0,0,0,0,0,0
SDAT,0,0,0,0,0,0,0
Sparrow,0,0,0,0,0,0,0
Anchor,0,1,2,3,0.0,33.33333333333333,66.66666666666666
Creamcoin,0,0,0,0,0,0,0
CINDX,0,0,0,0,0,0,0
Atlas Protocol,0,0,0,0,0,0,0
PlasmaPay,0,0,0,0,0,0,0
Raven Protocol,0,0,0,0,0,0,0
Bcnex,0,0,0,0,0,0,0
Triffic,0,0,0,0,0,0,0
CoTrader,0,0,0,0,0,0,0
MimbleWimbleCoin,0,0,0,0,0,0,0
MiMiDi,0,0,0,0,0,0,0
Globatalent,0,0,0,0,0,0,0
Xprivate Chat,0,0,0,0,0,0,0
Homebloc,0,0,0,0,0,0,0
XR Web,0,0,0,0,0,0,0
SUKU,0,0,0,0,0,0,0
diamDEXX,0,0,0,0,0,0,0
Ampleforth,0,0,0,0,0,0,0
Minglechain,0,0,0,0,0,0,0
Bitwings,0,0,0,0,0,0,0
UHIVE,0,0,0,0,0,0,0
Tryvium,0,0,0,0,0,0,0
AiBB,0,0,0,0,0,0,0
Dukascoin,0,0,0,0,0,0,0
SixDomainChain,0,0,0,0,0,0,0
Crypto Market Ads,0,0,0,0,0,0,0
UniversalCoin,0,0,0,0,0,0,0
P2PS,0,0,0,0,0,0,0
SOCIAL CHAINS,0,0,0,0,0,0,0
Reserve Round 2,0,0,0,0,0,0,0
DVMarketplace,0,0,0,0,0,0,0
Bank of Hodlers,0,0,0,0,0,0,0
Opiria,0,0,0,0,0,0,0
Kozjin,0,0,0,0,0,0,0
BULLEX,0,0,0,0,0,0,0
AllSesame,0,0,0,0,0,0,0
Fesschain,0,0,0,0,0,0,0
Dayta,0,0,0,0,0,0,0
Mindexcoin,0,0,0,0,0,0,0
GRAYLL,0,0,0,0,0,0,0
Ferrum Network,0,0,0,0,0,0,0
TEN,672,350,314,1336,50.29940119760479,26.19760479041916,23.502994011976046
NOIA Network,0,0,0,0,0,0,0
Matrix AI Network,0,0,0,0,0,0,0
AMUSE,0,2,0,2,0.0,100.0,0.0
MediConnect,0,0,0,0,0,0,0
BitTube,0,0,0,0,0,0,0
Authpaper,0,0,0,0,0,0,0
BTSCOIN,0,0,0,0,0,0,0
CoinHe,0,0,0,0,0,0,0
LocalCoin,0,0,0,0,0,0,0
StellarPay,0,0,0,0,0,0,0
IOTW,0,0,0,0,0,0,0
Cryptoxygen,0,0,0,0,0,0,0
CINEMADROM,0,0,0,0,0,0,0
Fusion Coin,0,0,0,0,0,0,0
CBNT,0,0,0,0,0,0,0
ODEM,0,0,0,0,0,0,0
EarthBi,0,0,0,0,0,0,0
Venoty,0,0,0,0,0,0,0
Futurepia,0,0,0,0,0,0,0
RTREE,0,0,0,0,0,0,0
Streamex,0,0,0,0,0,0,0
Tipestry,0,0,0,0,0,0,0
Betinance,0,0,0,0,0,0,0
BitForex,0,0,0,0,0,0,0
Coinquista,0,0,0,0,0,0,0
AMANPURI,0,0,0,0,0,0,0
Atomic Wallet,27,0,1,28,96.42857142857143,0.0,3.571428571428571
Five Colors Coin,0,0,0,0,0,0,0
EVEN Foundation,0,0,0,0,0,0,0
Konstellation,0,0,0,0,0,0,0
Gemstra,0,0,0,0,0,0,0
Chelle Coin,0,0,0,0,0,0,0
Pukkamex,0,0,0,0,0,0,0
AVXChange,0,0,0,0,0,0,0
eden.best,0,0,0,0,0,0,0
Licht Project,0,0,0,0,0,0,0
Trade Nexi,0,0,0,0,0,0,0
OpenWeb Network,0,0,0,0,0,0,0
Somesing,0,0,0,0,0,0,0
Vite,6,0,3,9,66.66666666666666,0.0,33.33333333333333
MADANA,0,0,0,0,0,0,0
Knowledge,54,31,43,128,42.1875,24.21875,33.59375
Block and Chain,0,0,0,0,0,0,0
Monarch,1,0,0,1,100.0,0.0,0.0
Ally Network,0,0,0,0,0,0,0
Files.fm,0,0,0,0,0,0,0
Terra Credit,0,0,0,0,0,0,0
Tangle,9,6,6,21,42.857142857142854,28.57142857142857,28.57142857142857
Vecap,0,0,0,0,0,0,0
Havaex,0,0,0,0,0,0,0
FST Network,0,0,0,0,0,0,0
Vodi X,0,0,0,0,0,0,0
QuarkChain,0,0,0,0,0,0,0
Purple Butterfly Trading,0,0,0,0,0,0,0
Digitex,0,0,0,0,0,0,0
Omnity,0,0,0,0,0,0,0
Sheepcoin,0,0,0,0,0,0,0
QuiGig,0,0,0,0,0,0,0
UMA,146,81,45,272,53.67647058823529,29.77941176470588,16.544117647058822
VINE Protocol,0,0,0,0,0,0,0
Opensea Traders,0,0,0,0,0,0,0
Mofi Finance,0,0,0,0,0,0,0
POAP,0,0,0,0,0,0,0
Moozicore,2,0,0,2,100.0,0.0,0.0
CryptoSoul,0,0,0,0,0,0,0
Nodis,0,0,0,0,0,0,0
Solve.Care,0,0,0,0,0,0,0
4hiphop,0,0,0,0,0,0,0
Almeedex,0,0,0,0,0,0,0
Saiterm,0,0,0,0,0,0,0
XCOYNZ,0,0,0,0,0,0,0
BtcEX,0,0,0,0,0,0,0
VANM,0,0,0,0,0,0,0
HyperionX,0,0,0,0,0,0,0
Crypto Potential,0,0,0,0,0,0,0
WOWX,0,0,0,0,0,0,0
TriipMiles,0,0,0,0,0,0,0
YellowTradingCoin,0,0,0,0,0,0,0
Bluenote,0,0,0,0,0,0,0
Cogmento,0,0,0,0,0,0,0
XPChain,0,0,0,0,0,0,0
KRONN,0,0,0,0,0,0,0
GLAD Network,0,0,0,0,0,0,0
TheVault,0,0,0,0,0,0,0
CoinTiger,0,1,1,2,0.0,50.0,50.0
Precium Foundation,0,0,0,0,0,0,0
Global Cryptocurrency,0,0,0,0,0,0,0
Z-POP DREAM,0,0,0,0,0,0,0
WHIRL,0,0,0,0,0,0,0
Daily Coin News,0,0,0,0,0,0,0
BitTorrent,0,0,1,1,0.0,0.0,100.0
Hxro,0,0,0,0,0,0,0
DACC,0,0,0,0,0,0,0
Singh,0,0,0,0,0,0,0
POP Network,0,0,0,0,0,0,0
MESG,0,0,0,0,0,0,0
DataOnBlock,0,0,0,0,0,0,0
PROOF OF TOSS,0,0,0,0,0,0,0
TerraGreen,0,0,0,0,0,0,0
PaxPago,0,0,0,0,0,0,0
Afincoin,0,0,0,0,0,0,0
The Collective,0,2,0,2,0.0,100.0,0.0
LTO Network,0,0,0,0,0,0,0
Insights Network,0,0,0,0,0,0,0
Cloverdex,0,0,0,0,0,0,0
DecentraX,0,0,0,0,0,0,0
Volentix,1,0,0,1,100.0,0.0,0.0
Energi,0,0,0,0,0,0,0
Opu Labs,0,0,0,0,0,0,0
ShareMeAll,0,0,0,0,0,0,0
MyCryptoBank,0,0,0,0,0,0,0
Grailum Lab,0,0,0,0,0,0,0
Petchains,0,0,0,0,0,0,0
Paradise Token,0,0,0,0,0,0,0
Game Fanz,0,0,0,0,0,0,0
Konkrete,0,0,0,0,0,0,0
KlickZie,0,0,0,0,0,0,0
TradePlace,0,0,0,0,0,0,0
Ares Tech,0,0,0,0,0,0,0
HubrisOne,0,0,0,0,0,0,0
PerksCoin,0,0,0,0,0,0,0
Sentivate,0,0,0,0,0,0,0
Bitcoin Confidential,0,0,0,0,0,0,0
Dragonglass,0,0,0,0,0,0,0
THORChain,2,1,0,3,66.66666666666666,33.33333333333333,0.0
Griffex,0,0,0,0,0,0,0
Accumulus Threat Shield,0,0,0,0,0,0,0
EARNET,0,0,0,0,0,0,0
MobileGo,0,0,0,0,0,0,0
HotelLoad,0,0,0,0,0,0,0
DNN,0,0,0,0,0,0,0
Playgroundz,0,0,0,0,0,0,0
BitSong,0,0,0,0,0,0,0
OmniBazaar,0,0,0,0,0,0,0
Inmax,1,3,0,4,25.0,75.0,0.0
Platon Finance,0,0,0,0,0,0,0
idap.io,0,0,0,0,0,0,0
Levolution,0,0,0,0,0,0,0
Bethereum,0,0,0,0,0,0,0
GAMB,36,19,6,61,59.01639344262295,31.147540983606557,9.836065573770492
Ice Chain,0,0,0,0,0,0,0
Pareto Network,0,0,0,0,0,0,0
Solarex,0,0,0,0,0,0,0
Spectrum,5,11,5,21,23.809523809523807,52.38095238095239,23.809523809523807
Faba,2,1,1,4,50.0,25.0,25.0
Indochain,0,0,0,0,0,0,0
Liquid (Raffle),0,0,0,0,0,0,0
VeganNation,0,0,0,0,0,0,0
Dsion,0,0,0,0,0,0,0
Tokenville,0,0,0,0,0,0,0
Gooreo,0,0,0,0,0,0,0
PopulStay,0,0,0,0,0,0,0
Uris,19,14,6,39,48.717948717948715,35.8974358974359,15.384615384615385
Havven,0,0,0,0,0,0,0
CryptoBonusMiles,0,0,0,0,0,0,0
Jarvis,0,0,0,0,0,0,0
Bancryp,0,0,0,0,0,0,0
MEDoctor,0,0,0,0,0,0,0
Cubego,0,0,0,0,0,0,0
Unification,0,0,0,0,0,0,0
Mind AI,0,0,0,0,0,0,0
Cures Token,0,0,0,0,0,0,0
Mobile Token Bank,0,0,0,0,0,0,0
GoDDEX,0,0,0,0,0,0,0
SpringRole,0,0,0,0,0,0,0
Securypto,0,0,0,0,0,0,0
Dolla,53,22,53,128,41.40625,17.1875,41.40625
Tune Token,0,0,0,0,0,0,0
V SYSTEMS,0,0,0,0,0,0,0
OcNet,0,0,0,0,0,0,0
Orbise,0,0,0,0,0,0,0
Sonata.ai,0,0,0,0,0,0,0
Phoneum,0,0,0,0,0,0,0
C2C,0,0,0,0,0,0,0
BitCanna,0,0,0,0,0,0,0
Smart Trade Coin,0,0,0,0,0,0,0
Wellmee,0,0,0,0,0,0,0
Varius World Tech,0,0,2,2,0.0,0.0,100.0
ZenSports,0,0,0,0,0,0,0
Raido,0,0,0,0,0,0,0
Biton,0,0,0,0,0,0,0
Tokedo,0,0,0,0,0,0,0
UniFox,0,0,0,0,0,0,0
One Solution,0,0,0,0,0,0,0
PGF500,0,0,0,0,0,0,0
Datafund,0,0,0,0,0,0,0
Trippki,0,0,0,0,0,0,0
Murmur,0,0,0,0,0,0,0
Rewards,22,7,19,48,45.83333333333333,14.583333333333334,39.58333333333333
Namacoin,0,0,0,0,0,0,0
THE 4TH PILLAR,0,0,0,0,0,0,0
QUBAY,0,0,0,0,0,0,0
SocialRemit,0,0,0,0,0,0,0
ALLIVE,0,0,0,0,0,0,0
Clear Foundation,0,0,0,0,0,0,0
TheFund.io,0,0,0,0,0,0,0
Qobit,0,0,0,0,0,0,0
GAMO Protocol,0,0,0,0,0,0,0
Bitozz,0,0,0,0,0,0,0
ND Invest,16,15,14,45,35.55555555555556,33.33333333333333,31.11111111111111
GG International,0,0,0,0,0,0,0
Tradesprite,0,0,0,0,0,0,0
VeryFile,0,0,0,0,0,0,0
TEMCO,0,0,0,0,0,0,0
Social Note,0,0,0,0,0,0,0
XRP by Huobi,0,0,0,0,0,0,0
X Infinity,0,0,0,0,0,0,0
FanChain,0,0,0,0,0,0,0
Fidelity House,0,0,0,0,0,0,0
Bitcademy,0,0,0,0,0,0,0
FiiiCoin,0,0,0,0,0,0,0
Platin,5,1,1,7,71.42857142857143,14.285714285714285,14.285714285714285
HintChain,0,0,0,0,0,0,0
London Block Exchange,0,0,0,0,0,0,0
Phoenix,3,3,1,7,42.857142857142854,42.857142857142854,14.285714285714285
Athero,0,0,0,0,0,0,0
BitValve,0,0,0,0,0,0,0
ARCC,0,0,0,0,0,0,0
Verity,9,7,6,22,40.909090909090914,31.818181818181817,27.27272727272727
Belacam,0,0,0,0,0,0,0
BlocPal,0,0,0,0,0,0,0
Mindsync,0,0,0,0,0,0,0
Velic,0,0,0,0,0,0,0
HighBank,1,0,0,1,100.0,0.0,0.0
FortFC,0,0,0,0,0,0,0
CurveBlock,0,0,0,0,0,0,0
Huddl,0,0,0,0,0,0,0
FEEDOCK,0,0,0,0,0,0,0
HARA,189,48,47,284,66.54929577464789,16.901408450704224,16.549295774647888
Vreo,0,0,0,0,0,0,0
HiLynk,0,0,0,0,0,0,0
Depository Network,0,0,0,0,0,0,0
Ellcrys,0,0,0,0,0,0,0
Bitpanda,1,0,0,1,100.0,0.0,0.0
Consensus,7,3,2,12,58.333333333333336,25.0,16.666666666666664
Stox,0,0,0,0,0,0,0
Mycro Jobs,0,0,0,0,0,0,0
Instant Sponsor,0,0,0,0,0,0,0
GoFind.World,0,0,0,0,0,0,0
MinedBlock,0,0,0,0,0,0,0
Crypt-ON,0,0,0,0,0,0,0
CoinJax,0,0,0,0,0,0,0
LEXIT,15,23,7,45,33.33333333333333,51.11111111111111,15.555555555555555
AIVON,0,0,0,0,0,0,0
Archetypal Network,0,0,0,0,0,0,0
B21,0,0,0,0,0,0,0
Open Packaging Network,0,0,0,0,0,0,0
Bistox Exchange,0,0,0,0,0,0,0
FortKnoxster,0,0,0,0,0,0,0
Connecty,0,0,0,0,0,0,0
Truwho,0,0,0,0,0,0,0
Hydro Protocol,0,0,0,0,0,0,0
Kidbizo,0,0,0,0,0,0,0
SIRIN LABS,0,0,0,0,0,0,0
Get Achieve,0,0,0,0,0,0,0
Bright Network,0,0,0,0,0,0,0
Sentinel,0,0,0,0,0,0,0
Certified Diamond Coin,0,0,0,0,0,0,0
idealcoin,0,0,0,0,0,0,0
GOZO,0,0,0,0,0,0,0
Smart Refinery Technologies,0,0,0,0,0,0,0
Javvy,0,0,0,0,0,0,0
STAYGE,0,0,0,0,0,0,0
Zulu Republic,0,0,0,0,0,0,0
Aelf,0,0,0,0,0,0,0
ETH Birds,0,0,0,0,0,0,0
weBloc,0,0,0,0,0,0,0
Superbloom,0,0,0,0,0,0,0
Rise,82,55,35,172,47.674418604651166,31.976744186046513,20.348837209302324
Bitsrent,0,0,0,0,0,0,0
Cryptocoin Insurance,0,0,0,0,0,0,0
Job.com,0,0,0,0,0,0,0
Bionic,0,0,0,0,0,0,0
Renaissance Engineering,0,0,0,0,0,0,0
Cubiex,0,0,0,0,0,0,0
Qredit,0,0,0,0,0,0,0
DigitalBits,0,0,0,0,0,0,0
IUNO,0,0,0,0,0,0,0
eMusic,0,0,0,0,0,0,0
Restart Energy,0,0,0,0,0,0,0
Infinitus,0,0,0,0,0,0,0
Lampix,0,0,0,0,0,0,0
Magnetics,0,0,0,0,0,0,0
AORA,0,0,0,0,0,0,0
Sportsfix,0,0,0,0,0,0,0
Qlear Protocol,0,0,0,0,0,0,0
MorLabs,0,0,0,0,0,0,0
WooshCoin,0,0,0,0,0,0,0
Coinbates,0,0,0,0,0,0,0
ONO,279,119,55,453,61.58940397350994,26.269315673289185,12.141280353200882
Triphop,0,0,0,0,0,0,0
Neironix,0,0,0,0,0,0,0
PowerChain,0,0,0,0,0,0,0
Xenia,0,0,0,0,0,0,0
Your Data Safe,0,0,0,0,0,0,0
Pigzbe,0,0,0,0,0,0,0
Balehu Protocol,0,0,0,0,0,0,0
Storiqa,0,0,0,0,0,0,0
Centaure,0,0,0,0,0,0,0
Loopring,0,0,0,0,0,0,0
AI Crypto,0,0,0,0,0,0,0
SPIN Protocol,0,0,0,0,0,0,0
Social Media Pay,0,0,0,0,0,0,0
ABBC foundation,0,0,0,0,0,0,0
REDi,125,52,49,226,55.309734513274336,23.008849557522122,21.68141592920354
LogisticsX,0,0,0,0,0,0,0
FasTrader,0,0,0,0,0,0,0
TokenBacon,0,0,0,0,0,0,0
SUAPP,0,0,0,0,0,0,0
DISTRICTS,0,0,0,0,0,0,0
ECTA,21,8,4,33,63.63636363636363,24.242424242424242,12.121212121212121
Silent Notary,0,0,0,0,0,0,0
Centive,44,33,24,101,43.56435643564357,32.67326732673268,23.762376237623762
PingPaid,0,0,0,0,0,0,0
Becent,0,0,0,0,0,0,0
XTribe,0,0,0,0,0,0,0
INLOCK,0,0,0,0,0,0,0
Krypti,0,0,0,0,0,0,0
ASOBI COIN,0,0,0,0,0,0,0
Borneo,1,0,0,1,100.0,0.0,0.0
Nerves Foundation,0,0,0,0,0,0,0
Tatau,0,0,0,0,0,0,0
Aenco,0,0,0,0,0,0,0
CyberVein,0,0,0,0,0,0,0
Karatcoin,0,0,0,0,0,0,0
ArtPro,0,0,0,0,0,0,0
Penchant,0,0,0,0,0,0,0
Parkade,0,0,0,0,0,0,0
NonZero,0,0,0,0,0,0,0
Cardonio,0,0,0,0,0,0,0
Sansox,0,0,0,0,0,0,0
Swachhcoin,0,0,0,0,0,0,0
Shopin,0,0,0,0,0,0,0
Blockkonnect,0,0,0,0,0,0,0
dClinic,0,0,0,0,0,0,0
X-Cash,0,0,0,0,0,0,0
Vibeo,0,0,0,0,0,0,0
Masternode Invest,0,0,0,0,0,0,0
Topex,0,0,0,0,0,0,0
Berminal,0,0,0,0,0,0,0
Expanse,1,0,0,1,100.0,0.0,0.0
Osmium Investment Coin,0,0,0,0,0,0,0
AURA,17,4,3,24,70.83333333333334,16.666666666666664,12.5
WMpro,0,0,0,0,0,0,0
Securix,0,0,0,0,0,0,0
UDAP,0,0,0,0,0,0,0
Olife,4,0,0,4,100.0,0.0,0.0
Curaizon,0,0,0,0,0,0,0
ODIN,13,13,5,31,41.935483870967744,41.935483870967744,16.129032258064516
Contents Protocol,0,0,0,0,0,0,0
Beverage Cash,0,0,0,0,0,0,0
XMax,0,0,0,0,0,0,0
Scienceroot,0,0,0,0,0,0,0
Spheroid Universe,2,0,0,2,100.0,0.0,0.0
X-Block,0,0,0,0,0,0,0
Buying,71,21,34,126,56.34920634920635,16.666666666666664,26.984126984126984
One Game,0,0,0,0,0,0,0
WOM Token,0,0,0,0,0,0,0
Caspian,0,0,0,0,0,0,0
iLink2Music,0,0,0,0,0,0,0
Natmin Pure Escrow,0,0,0,0,0,0,0
Kineticex,0,0,0,0,0,0,0
Zwoop,0,0,0,0,0,0,0
INDX Capital,0,0,0,0,0,0,0
PayX,0,0,0,0,0,0,0
Skynet,0,0,0,0,0,0,0
LoveBlock,0,0,0,0,0,0,0
TTC PROTOCOL,0,0,0,0,0,0,0
Bithereum,0,0,0,0,0,0,0
MOAC,0,0,0,0,0,0,0
Bitfam,0,0,0,0,0,0,0
Republia,0,0,0,0,0,0,0
FUNKEYpay,0,0,0,0,0,0,0
Papusha,0,0,0,0,0,0,0
iTrue,0,0,0,0,0,0,0
Beam,0,9,3,12,0.0,75.0,25.0
KiMex,0,0,0,0,0,0,0
Twogap,0,0,0,0,0,0,0
LATTICE80,0,0,0,0,0,0,0
Florafic,0,0,0,0,0,0,0
BitMart,0,1,1,2,0.0,50.0,50.0
Efforce,0,0,0,0,0,0,0
Spiking,0,0,0,0,0,0,0
Bidooh,0,0,0,0,0,0,0
imusify,0,0,0,0,0,0,0
ICOVO,0,0,0,0,0,0,0
Cloudbric,0,0,0,0,0,0,0
Tachain,0,0,0,0,0,0,0
WorkChain,0,0,0,0,0,0,0
BrokerNekoNetwork,0,0,0,0,0,0,0
SUBAJ,0,0,0,0,0,0,0
Scanetchain,0,0,0,0,0,0,0
Payperblock,0,0,0,0,0,0,0
Greenlink,0,0,0,0,0,0,0
55 Exchange,0,0,0,0,0,0,0
Finnoq,0,0,0,0,0,0,0
Platio,0,0,0,0,0,0,0
DX.Exchange,0,0,0,0,0,0,0
BCoin,0,0,0,0,0,0,0
Skrumble Network,0,0,0,0,0,0,0
EtherInc,0,0,0,0,0,0,0
MyOS,0,0,0,0,0,0,0
EurekaPro,0,0,0,0,0,0,0
Avatara,0,0,0,0,0,0,0
ODYSSEY,0,0,0,0,0,0,0
Rate3,0,0,0,0,0,0,0
Bouncy Coin,0,0,0,0,0,0,0
AgentMile,0,0,0,0,0,0,0
Hirefreehands,0,0,0,0,0,0,0
Denarii Cash,0,0,0,0,0,0,0
WebDollar,0,0,0,0,0,0,0
WeBuy,0,0,0,0,0,0,0
MECA Coin,0,0,0,0,0,0,0
ABELE GROUP,0,0,0,0,0,0,0
AGATE,2,0,1,3,66.66666666666666,0.0,33.33333333333333
Kronos Token,0,0,0,0,0,0,0
Wandx,0,0,0,0,0,0,0
Envoy,0,0,0,0,0,0,0
iRide,0,0,0,0,0,0,0
Synthetics AI,0,0,0,0,0,0,0
Symphony,0,0,0,0,0,0,0
Margin,20,15,11,46,43.47826086956522,32.608695652173914,23.91304347826087
GSC Aviation,0,0,0,0,0,0,0
Share Internet Data,0,0,0,0,0,0,0
MetaHash,0,0,0,0,0,0,0
HyperQuant,0,0,0,0,0,0,0
Kheper,0,0,0,0,0,0,0
Opporty,3,0,0,3,100.0,0.0,0.0
Blackbox Foundation,0,0,0,0,0,0,0
MedChain,0,0,0,0,0,0,0
VIDDO,0,0,0,0,0,0,0
GreenHashes,0,0,0,0,0,0,0
Pearl Pay,0,0,0,0,0,0,0
High Performance Blockchain,0,0,0,0,0,0,0
Conference Coin,0,0,0,0,0,0,0
YondoCoin,0,0,0,0,0,0,0
Kvantor,0,0,0,0,0,0,0
Jupiter Chain,0,0,0,0,0,0,0
ZeroState,0,0,0,0,0,0,0
MapCoin,0,0,0,0,0,0,0
EyeGlob.Net,0,0,0,0,0,0,0
Crypviser,0,0,0,0,0,0,0
MARAChain,0,0,0,0,0,0,0
NextPakk,0,0,0,0,0,0,0
Distributed Blocks,0,0,0,0,0,0,0
Fieldcoin,0,0,0,0,0,0,0
VEIAG,0,0,0,0,0,0,0
LockTrip,0,0,0,0,0,0,0
ZINC,0,0,0,0,0,0,0
Spl.yt,0,0,0,0,0,0,0
SilkChain,0,0,0,0,0,0,0
unitalent,0,0,0,0,0,0,0
CareerChain,0,0,0,0,0,0,0
CraftR,0,0,0,0,0,0,0
Thingschain,0,0,0,0,0,0,0
Hashgard,0,0,0,0,0,0,0
Daviescoin,0,0,0,0,0,0,0
Contractium,0,0,0,0,0,0,0
MOBU,0,0,0,0,0,0,0
Philanthor,0,0,0,0,0,0,0
Medipedia,0,0,0,0,0,0,0
TLPAC,0,0,0,0,0,0,0
Sports Ledger,0,0,0,0,0,0,0
Real Estate Doc,0,0,0,0,0,0,0
CAREONchain,0,0,0,0,0,0,0
Project H,15,0,1,16,93.75,0.0,6.25
DREAM & INDORSE,0,0,0,0,0,0,0
BuratinoBS,0,0,0,0,0,0,0
OpenBrix,0,0,0,0,0,0,0
VU Token,0,0,0,0,0,0,0
BolieCoin,0,0,0,0,0,0,0
CampusCoin,0,0,0,0,0,0,0
RIPAEX,0,0,0,0,0,0,0
BlockVest,0,0,0,0,0,0,0
NeoPlace,0,0,0,0,0,0,0
INTRO,29,14,20,63,46.03174603174603,22.22222222222222,31.746031746031743
GStar Ecosystem,0,0,0,0,0,0,0
Everipedia,0,0,0,0,0,0,0
ZeroBank,0,0,0,0,0,0,0
Vidy,0,0,0,0,0,0,0
Attrace,0,0,0,0,0,0,0
SVPER,0,0,0,0,0,0,0
RockerCoin,0,0,0,0,0,0,0
Rays Network,0,0,0,0,0,0,0
Tokenize,2,7,0,9,22.22222222222222,77.77777777777779,0.0
Dream Real,1,0,0,1,100.0,0.0,0.0
Asian Develop Coin,0,0,0,0,0,0,0
AIRSTAYZ,0,0,0,0,0,0,0
YINC,0,0,0,0,0,0,0
BLOXIA,0,0,0,0,0,0,0
Color,48,20,11,79,60.75949367088608,25.31645569620253,13.924050632911392
Watermelonblock,0,0,0,0,0,0,0
Hurtle Coin,0,0,0,0,0,0,0
BIGBANG,0,0,0,0,0,0,0
Starflow,0,0,0,0,0,0,0
MYTC,0,0,0,0,0,0,0
Aniko,0,0,0,0,0,0,0
W Green Pay,0,0,0,0,0,0,0
GUARIUM,0,0,0,0,0,0,0
Prime Shipping Foundation,0,0,0,0,0,0,0
Propy,0,0,0,0,0,0,0
Easy Trading Platform,0,0,0,0,0,0,0
DNeT,3,0,0,3,100.0,0.0,0.0
Meritt protocol,0,0,0,0,0,0,0
STAR BIT,0,0,0,0,0,0,0
MulTra,0,0,0,0,0,0,0
Expercoin,0,0,0,0,0,0,0
Kava,0,0,1,1,0.0,0.0,100.0
Bytemine,0,0,0,0,0,0,0
UNICO,3,2,2,7,42.857142857142854,28.57142857142857,28.57142857142857
Diro,0,0,0,0,0,0,0
Gratzio,0,0,0,0,0,0,0
Bixtrim,0,0,0,0,0,0,0
Inmediate,0,0,0,0,0,0,0
JSEcoin,0,0,0,0,0,0,0
MediLOT,0,0,0,0,0,0,0
PCHAIN,0,0,0,0,0,0,0
HELIX Orange,0,0,0,0,0,0,0
Shipit,0,0,0,0,0,0,0
Miracle Tele,0,0,0,0,0,0,0
Runs,36,8,1,45,80.0,17.77777777777778,2.2222222222222223
IGNITE,0,1,0,1,0.0,100.0,0.0
eLYQD,0,0,0,0,0,0,0
Bailsman,0,0,0,0,0,0,0
Lambda,0,0,0,0,0,0,0
Rubius,0,0,0,0,0,0,0
Svandis,4,0,0,4,100.0,0.0,0.0
AllSporter,0,0,0,0,0,0,0
Playrs,0,0,0,0,0,0,0
CoinAnalyst,0,0,0,0,0,0,0
Spokkz,0,0,0,0,0,0,0
Zantepay,0,0,0,0,0,0,0
Cure Cosplay,0,0,0,0,0,0,0
WAB Network,0,0,0,0,0,0,0
Liquid8,0,0,0,0,0,0,0
Fanship,0,0,0,0,0,0,0
Inmusik,0,0,0,0,0,0,0
CrowdToken,0,0,0,0,0,0,0
OSA,9,11,2,22,40.909090909090914,50.0,9.090909090909092
moolyacoin,0,0,0,0,0,0,0
Hyperbridge,0,0,0,0,0,0,0
TombCare,0,0,0,0,0,0,0
Tuurnt,0,0,0,0,0,0,0
Usechain,0,0,0,0,0,0,0
Storeplex,0,0,0,0,0,0,0
ParcelX,0,0,0,0,0,0,0
APRES,0,0,0,0,0,0,0
Blockhive,0,0,0,0,0,0,0
Creatanium,0,0,0,0,0,0,0
TradeRiser,0,0,0,0,0,0,0
RedCab,0,0,0,0,0,0,0
Monopoly,1,0,0,1,100.0,0.0,0.0
Sharevest,0,0,0,0,0,0,0
Explorio,0,0,0,0,0,0,0
EPIPHANY,0,0,0,0,0,0,0
BUMO,0,0,0,0,0,0,0
Barrel,0,1,1,2,0.0,50.0,50.0
CryptoMillionsLotto,0,0,0,0,0,0,0
ImmVRse,0,0,0,0,0,0,0
Atidium,0,0,0,0,0,0,0
DTO,13,0,3,16,81.25,0.0,18.75
Provoco,0,0,0,0,0,0,0
TraXion,0,0,0,0,0,0,0
BitEsprit,0,0,0,0,0,0,0
HEROIC.com,0,0,0,0,0,0,0
Dench Music,0,0,0,0,0,0,0
Versara Trade,0,0,0,0,0,0,0
MiBoodle,0,0,0,0,0,0,0
HelloGold,0,0,0,0,0,0,0
ODMCoin,0,0,0,0,0,0,0
Waves,2,2,1,5,40.0,40.0,20.0
MEvU,0,0,0,0,0,0,0
Casper API,0,0,0,0,0,0,0
Lition,5,3,0,8,62.5,37.5,0.0
SciDex,0,0,0,0,0,0,0
Betform,0,0,0,0,0,0,0
Yanu,0,0,0,0,0,0,0
Little Phil,0,0,0,0,0,0,0
Monoreto,0,0,0,0,0,0,0
Grapevine World,0,0,0,0,0,0,0
Blockonomics,0,0,0,0,0,0,0
Nauticus,0,0,0,0,0,0,0
Further Network,0,0,0,0,0,0,0
Breezecoin,0,0,0,0,0,0,0
RAcoin,0,0,0,0,0,0,0
TRESARO,0,0,0,0,0,0,0
Wemark,0,0,0,0,0,0,0
Setteo,0,0,0,0,0,0,0
ERN,392,239,183,814,48.157248157248155,29.361179361179364,22.48157248157248
Terawatt,0,0,0,0,0,0,0
CryptovationX,0,0,0,0,0,0,0
Feedchain,0,0,0,0,0,0,0
Basis Neuro,0,0,0,0,0,0,0
Staramba,0,0,0,0,0,0,0
re:factor,0,0,0,0,0,0,0
GreenX,0,0,0,0,0,0,0
FTW,22,26,12,60,36.666666666666664,43.333333333333336,20.0
Atlantis Blue,0,0,0,0,0,0,0
Parkres,0,0,0,0,0,0,0
LendsBay,0,0,0,0,0,0,0
0xcert,0,0,0,0,0,0,0
Humanscape,0,0,0,0,0,0,0
CrowdIF,0,0,0,0,0,0,0
VideoCoin,0,0,0,0,0,0,0
Nebula,0,0,0,0,0,0,0
NeoNameService,0,0,0,0,0,0,0
Sparkster,0,0,0,0,0,0,0
Buddy,27,3,3,33,81.81818181818183,9.090909090909092,9.090909090909092
CrypStock,0,0,0,0,0,0,0
Luvdub,0,0,0,0,0,0,0
Aworker,0,0,0,0,0,0,0
QLC Chain,0,0,0,0,0,0,0
Sponsy,0,0,0,0,0,0,0
Menlo One,0,0,0,0,0,0,0
WeSend,0,0,0,0,0,0,0
InsCoin,0,0,0,0,0,0,0
ExTrade,0,0,0,0,0,0,0
MUXE,0,0,0,0,0,0,0
Lina,2,0,0,2,100.0,0.0,0.0
Zoidcoin,0,0,0,0,0,0,0
Origin Sport,0,0,0,0,0,0,0
No BS Crypto,0,0,0,0,0,0,0
Cosmecoin,0,0,0,0,0,0,0
Railz,0,0,0,0,0,0,0
ContentBox,0,0,0,0,0,0,0
rLoop,0,0,0,0,0,0,0
Bitney,0,0,0,0,0,0,0
APIS,10,10,10,30,33.33333333333333,33.33333333333333,33.33333333333333
XMED Chain,0,0,0,0,0,0,0
IndiCoin,0,0,0,0,0,0,0
Nobar,0,0,0,0,0,0,0
Coinself,0,0,0,0,0,0,0
MAKEAFOLIO,0,0,0,0,0,0,0
Iris.ai,0,0,0,0,0,0,0
Deedcoin,0,0,0,0,0,0,0
DAV,3,2,4,9,33.33333333333333,22.22222222222222,44.44444444444444
Find.Exchange,0,0,0,0,0,0,0
INGOT Coin,0,0,0,0,0,0,0
Profede,0,0,0,0,0,0,0
Box 2 Table,0,0,0,0,0,0,0
GlobeCas,0,0,0,0,0,0,0
GOeureka,0,0,0,0,0,0,0
Xeeda,0,0,0,0,0,0,0
RecordsKeeper,0,0,0,0,0,0,0
DATAVLT,0,0,0,0,0,0,0
Jibbit,0,0,0,0,0,0,0
Loyakk,0,0,0,0,0,0,0
AVINOC,0,0,0,0,0,0,0
TokenUnion,0,0,0,0,0,0,0
Root Blockchain,0,0,0,0,0,0,0
Ormeus Coin,0,0,0,0,0,0,0
CryptoRiya,0,0,0,0,0,0,0
Mjolnir Guard,0,0,0,0,0,0,0
Daox,0,0,0,0,0,0,0
PavoCoin,0,0,0,0,0,0,0
Brainmab,0,0,0,0,0,0,0
Viewo,0,0,0,0,0,0,0
FanFare,0,0,0,0,0,0,0
Crystals,0,0,0,0,0,0,0
XGenomics,0,0,0,0,0,0,0
Gese,0,0,2,2,0.0,0.0,100.0
ASKfm 2.0,0,0,0,0,0,0,0
B2BX,0,0,0,0,0,0,0
Lamoneda,0,0,0,0,0,0,0
Accounting Blockchain,0,0,0,0,0,0,0
Energi Token,0,0,0,0,0,0,0
Nebeus,0,0,0,0,0,0,0
iRegMed,0,0,0,0,0,0,0
Paygine,0,0,0,0,0,0,0
Ivy,0,0,0,0,0,0,0
Binex.Trade,0,0,0,0,0,0,0
Selfie GO,0,0,0,0,0,0,0
Clash & GO,0,0,0,0,0,0,0
Miner Edge,0,0,0,0,0,0,0
Keplertek,0,0,0,0,0,0,0
Ink,835,331,394,1560,53.52564102564102,21.21794871794872,25.256410256410255
Kimera,0,0,0,0,0,0,0
Prime Ball,0,0,0,0,0,0,0
Aitheon,0,0,0,0,0,0,0
TaTaTu,0,0,0,0,0,0,0
SupPorter,5,12,2,19,26.31578947368421,63.1578947368421,10.526315789473683
Neodium Network,0,0,0,0,0,0,0
Acudeen,0,0,0,0,0,0,0
EasyLoot,0,0,0,0,0,0,0
VIMANA,0,0,0,0,0,0,0
DeNet,0,0,0,0,0,0,0
Goldma,3,0,0,3,100.0,0.0,0.0
Ommer,9,11,4,24,37.5,45.83333333333333,16.666666666666664
Viva Network,0,0,0,0,0,0,0
LeadRex,0,0,0,0,0,0,0
PO8,0,0,0,0,0,0,0
SmartMesh,0,0,0,0,0,0,0
ATN,0,9,6,15,0.0,60.0,40.0
Luna,11,0,1,12,91.66666666666666,0.0,8.333333333333332
Fenix,0,0,0,0,0,0,0
SuccessLife,0,0,0,0,0,0,0
Planport,0,0,0,0,0,0,0
DateCoin,0,0,0,0,0,0,0
ArchiCoin,0,0,0,0,0,0,0
CryptoHIT,0,0,0,0,0,0,0
JioJioMe,0,0,0,0,0,0,0
Genexi,0,0,0,0,0,0,0
mCoin,0,0,0,0,0,0,0
CONDA,34,18,5,57,59.64912280701754,31.57894736842105,8.771929824561402
Koumei,0,0,0,0,0,0,0
HODLit Network,0,0,0,0,0,0,0
SKYFchain,0,0,0,0,0,0,0
Coinyspace,0,0,0,0,0,0,0
Fructus,0,0,0,0,0,0,0
Horizon,2,3,0,5,40.0,60.0,0.0
KanadeCoin,0,0,0,0,0,0,0
Xriba,0,0,0,0,0,0,0
TowerBee,0,0,0,0,0,0,0
MST,32,14,15,61,52.459016393442624,22.950819672131146,24.59016393442623
ETHERC,0,0,0,0,0,0,0
Elepig,0,0,0,0,0,0,0
DINO,1,1,1,3,33.33333333333333,33.33333333333333,33.33333333333333
LaborCrypto,0,0,0,0,0,0,0
MD Tokens,0,0,0,0,0,0,0
BitImage,0,0,0,0,0,0,0
Byteball,0,0,0,0,0,0,0
GrabAMeal,0,0,0,0,0,0,0
GLEDOS,0,0,0,0,0,0,0
CarLive Chain,0,0,0,0,0,0,0
WONO,0,0,0,0,0,0,0
SelfSell,0,0,0,0,0,0,0
Acute Coin,0,0,0,0,0,0,0
CryptoFlix,0,0,0,0,0,0,0
HubToken,0,0,0,0,0,0,0
ICO Pass,0,0,0,0,0,0,0
Amicorum Live,0,0,0,0,0,0,0
Global REIT,0,0,0,0,0,0,0
WizeBit,0,0,0,0,0,0,0
Zichain,0,0,0,0,0,0,0
Tradingene,0,0,0,0,0,0,0
OkeyDokey,0,0,0,0,0,0,0
Birdchain,0,0,0,0,0,0,0
FreelancerCoin,0,0,0,0,0,0,0
Blue Whale,0,0,0,0,0,0,0
GoldMint,0,0,0,0,0,0,0
EvolutionOS,0,0,0,0,0,0,0
Linfinity,0,0,0,0,0,0,0
Cortex,0,0,0,0,0,0,0
Crowd for Angels,0,0,0,0,0,0,0
Iconiq Lab,0,0,0,0,0,0,0
Arousal,0,0,0,0,0,0,0
CGCX,0,0,0,0,0,0,0
WULET,0,0,0,0,0,0,0
Elysian,0,0,0,0,0,0,0
Coinet,0,0,0,0,0,0,0
Lancer Network,0,0,0,0,0,0,0
Safe Haven,0,0,0,0,0,0,0
ARAW Token,0,0,0,0,0,0,0
DirectHome,0,0,0,0,0,0,0
Buzcoin,0,0,0,0,0,0,0
DICEGAME,0,0,0,0,0,0,0
BeepBeep Nation,0,0,0,0,0,0,0
ABCC Exchange,0,0,0,0,0,0,0
Deconet,0,0,0,0,0,0,0
DataBlockchain,0,0,0,0,0,0,0
CarBlock,0,0,0,0,0,0,0
Bulleon,0,0,0,0,0,0,0
CoinCrowd,0,0,0,0,0,0,0
RankingBall,0,0,0,0,0,0,0
Bubbletone,0,0,0,0,0,0,0
MPCX,0,0,0,0,0,0,0
BlockStorage,0,0,0,0,0,0,0
XcelToken Plus,0,0,0,0,0,0,0
XCHNG,0,0,0,0,0,0,0
TrustLogics,0,0,0,0,0,0,0
BitRent,0,0,0,0,0,0,0
Free Market Token,0,0,0,0,0,0,0
StarChain,0,0,0,0,0,0,0
ABitchain,0,0,0,0,0,0,0
Check-Car,0,0,0,0,0,0,0
AI Gaming,0,0,0,0,0,0,0
AbacasXchange,0,0,0,0,0,0,0
Ether joy,0,0,0,0,0,0,0
Blockport,0,0,0,0,0,0,0
ConcertVR,0,0,0,0,0,0,0
BitMinutes,0,0,0,0,0,0,0
BFEX,0,0,0,0,0,0,0
Hangry Animals,0,0,0,0,0,0,0
Argent,1,0,0,1,100.0,0.0,0.0
Limocoinswap,0,0,0,0,0,0,0
Socean,0,0,0,0,0,0,0
CFun,0,0,0,0,0,0,0
Coin Governance System,0,0,0,0,0,0,0
Cryde,0,0,0,0,0,0,0
Belotto,0,0,0,0,0,0,0
Terra Virtua,0,0,0,0,0,0,0
Olympus Labs,0,0,0,0,0,0,0
Proton,1,0,0,1,100.0,0.0,0.0
Touch. Social Network,0,0,0,0,0,0,0
Zeex,0,0,0,0,0,0,0
AutoBay,0,0,0,0,0,0,0
CargoChain,0,0,0,0,0,0,0
4NEW,0,0,0,0,0,0,0
Moveco,0,0,0,0,0,0,0
GladAge,0,0,0,0,0,0,0
Indorse,0,0,0,0,0,0,0
Unboxed,0,0,0,0,0,0,0
MetaMorph,0,0,0,0,0,0,0
Delicia,0,0,0,0,0,0,0
0Chain,0,0,0,0,0,0,0
Esports Chain,0,0,0,0,0,0,0
Smart Trip Platform,0,0,0,0,0,0,0
TrustNote,0,0,0,0,0,0,0
Parsec Frontiers,0,0,0,0,0,0,0
Mine Coin,0,0,0,0,0,0,0
BITRUST,0,0,0,0,0,0,0
DeepToken,0,0,0,0,0,0,0
Workcoin,0,0,0,0,0,0,0
McFly,0,0,0,0,0,0,0
CoinMetro,0,0,0,0,0,0,0
Kryptono Exchange,0,0,0,0,0,0,0
dApp Builder,0,0,0,0,0,0,0
PreVUE,0,0,0,0,0,0,0
EthicHub Twitter,0,0,0,0,0,0,0
Urbit,3,0,0,3,100.0,0.0,0.0
Boosto,0,0,0,0,0,0,0
Assettoken,0,0,0,0,0,0,0
Anything App,0,0,0,0,0,0,0
Pointium,0,0,0,0,0,0,0
BIOK,0,0,0,0,0,0,0
BITMILLEX,0,0,0,0,0,0,0
Bidipass,0,0,0,0,0,0,0
Sentinel Protocol,0,0,0,0,0,0,0
MoneyToken,0,0,0,0,0,0,0
Bitsum,0,0,0,0,0,0,0
Endorsit,0,0,0,0,0,0,0
SDChain,0,0,0,0,0,0,0
Mingo,0,0,0,0,0,0,0
LibertyLance,0,0,0,0,0,0,0
Block Broker,0,0,0,0,0,0,0
Hyperion,0,0,0,0,0,0,0
Golden Currency,0,0,0,0,0,0,0
DigiPulse,0,0,0,0,0,0,0
EXCHAIN,0,0,0,0,0,0,0
Spindle,0,0,1,1,0.0,0.0,100.0
SEDA,2,0,0,2,100.0,0.0,0.0
ViValid,0,0,0,0,0,0,0
MBYS,0,0,0,0,0,0,0
Xenchain,0,0,0,0,0,0,0
Kakushin,0,0,0,0,0,0,0
EVO,145,33,21,199,72.8643216080402,16.582914572864322,10.552763819095476
Strykz,0,0,0,0,0,0,0
KELTA,0,0,0,0,0,0,0
RAWG,0,0,0,0,0,0,0
AICT,0,0,0,0,0,0,0
Meshbox,0,0,0,0,0,0,0
eosDAC,0,0,0,0,0,0,0
EatMeCoin,0,0,0,0,0,0,0
Superset,0,0,0,0,0,0,0
Coinpaws,0,0,0,0,0,0,0
Trident Group,0,0,0,0,0,0,0
Prontapay,0,0,0,0,0,0,0
Akaiito,0,0,0,0,0,0,0
SmartO,5,3,0,8,62.5,37.5,0.0
ENTRY,22,1,8,31,70.96774193548387,3.225806451612903,25.806451612903224
Digitize,0,0,0,0,0,0,0
VinChain,0,0,0,0,0,0,0
Bit.Game,0,0,0,0,0,0,0
Pecunio,0,0,0,0,0,0,0
LabStart,0,0,0,0,0,0,0
Vexanium,0,0,0,0,0,0,0
QRYPTOS Exchange,0,0,0,0,0,0,0
THEKEY,0,0,0,0,0,0,0
EchoLink,0,0,0,0,0,0,0
EthicHub,1,0,0,1,100.0,0.0,0.0
Marginless,0,0,0,0,0,0,0
ABLE,766,371,301,1438,53.26842837273992,25.799721835883172,20.931849791376912
Cosmochain,0,0,0,0,0,0,0
ChronoBank,0,0,0,0,0,0,0
BitRewards,0,0,0,0,0,0,0
Vanig,0,0,0,0,0,0,0
London Football Exchange,0,0,0,0,0,0,0
LemoChain,0,0,0,0,0,0,0
SurruS,0,0,0,0,0,0,0
CPROP,0,0,0,0,0,0,0
Bundle,7,1,0,8,87.5,12.5,0.0
3DES,0,0,0,0,0,0,0
Contract Vault,0,0,0,0,0,0,0
Modex,0,0,0,0,0,0,0
Modorr,0,0,0,0,0,0,0
BitFence,0,0,0,0,0,0,0
MaxiMine,0,0,0,0,0,0,0
Biotron,0,0,0,0,0,0,0
Berith,0,0,0,0,0,0,0
Moneda,0,0,0,0,0,0,0
CyteCoin,0,0,0,0,0,0,0
BitLumens,0,0,0,0,0,0,0
Union,25,5,4,34,73.52941176470588,14.705882352941178,11.76470588235294
BHOM,0,0,0,0,0,0,0
Potentiam,0,0,0,0,0,0,0
Emrify,0,0,0,0,0,0,0
Hai Project,0,0,0,0,0,0,0
LangNet,0,0,0,0,0,0,0
Ambr,1,0,0,1,100.0,0.0,0.0
Snovio,0,0,0,0,0,0,0
Alvalor,0,0,0,0,0,0,0
Triggmine,0,0,0,0,0,0,0
Thorium,0,0,0,0,0,0,0
Sport X,0,0,0,0,0,0,0
MOS,550,280,218,1048,52.48091603053435,26.717557251908396,20.801526717557252
VRT World,0,0,0,0,0,0,0
DateMe,0,0,0,0,0,0,0
Helios Protocol,0,0,0,0,0,0,0
Gravity GZRO,0,0,0,0,0,0,0
Gosama,0,0,0,0,0,0,0
LaneAxis,0,0,0,0,0,0,0
CRYPTTO,0,0,0,0,0,0,0
Sleecoin,0,0,0,0,0,0,0
NAU,13,3,8,24,54.166666666666664,12.5,33.33333333333333
TrigID,0,0,0,0,0,0,0
VeChain,1,0,0,1,100.0,0.0,0.0
NWP Solution,0,0,0,0,0,0,0
Kinguin,0,0,0,0,0,0,0
Goldiam,0,0,0,0,0,0,0
First Trading Ecosystem,0,0,0,0,0,0,0
Cybereits,0,0,0,0,0,0,0
Blocknubie,0,0,0,0,0,0,0
HOLD,130,64,77,271,47.97047970479705,23.616236162361623,28.413284132841326
BCharity,1,0,0,1,100.0,0.0,0.0
ALAX,1,0,0,1,100.0,0.0,0.0
Blockchain Hotels 2.0,0,0,0,0,0,0,0
Crypto Angel,0,0,0,0,0,0,0
Flashmoni,0,0,0,0,0,0,0
BLACKFOL.IO,0,0,0,0,0,0,0
Disciplina,0,0,0,0,0,0,0
Birake,0,0,0,0,0,0,0
ExtraCredit,0,0,0,0,0,0,0
HowDoo,0,0,0,0,0,0,0
SANCOJ,0,0,0,0,0,0,0
Smart Unit,0,0,0,0,0,0,0
Papyrus,0,0,0,0,0,0,0
WeiCrowd,0,0,0,0,0,0,0
Talao,0,0,0,0,0,0,0
Etheal,0,0,0,0,0,0,0
StasyQ,0,0,0,0,0,0,0
BTU Protocol,0,0,0,0,0,0,0
Pantos by Bitpanda,0,0,0,0,0,0,0
Safein,0,0,0,0,0,0,0
Eniac Network,0,0,0,0,0,0,0
Fox Trading,0,0,0,0,0,0,0
Decibels,0,0,0,0,0,0,0
MF Chain,0,0,0,0,0,0,0
Cryptelo,0,0,0,0,0,0,0
Cartel,1,0,0,1,100.0,0.0,0.0
Bobâs Repair,0,0,0,0,0,0,0
Measurable Data Token,0,0,0,0,0,0,0
Blok,0,0,0,0,0,0,0
AdSigma,0,0,0,0,0,0,0
PayVX,0,0,0,0,0,0,0
Instant Assets Tokens,0,0,0,0,0,0,0
Algebraix,0,0,0,0,0,0,0
Chimaera,0,0,0,0,0,0,0
Essentia,18,13,20,51,35.294117647058826,25.49019607843137,39.21568627450981
Pibble,0,0,0,0,0,0,0
eCharge,0,1,0,1,0.0,100.0,0.0
Flux,0,0,0,0,0,0,0
LAPO,0,0,0,0,0,0,0
VeriME,0,0,0,0,0,0,0
Crestonium,0,0,0,0,0,0,0
OS University,0,0,0,0,0,0,0
Friend Unifying Platform,0,0,0,0,0,0,0
Photochain,0,0,0,0,0,0,0
Aeternum,0,0,0,0,0,0,0
Xmoneta,0,0,0,0,0,0,0
Aphelion,0,0,0,0,0,0,0
Koios,0,0,0,0,0,0,0
Blockshipping,0,0,0,0,0,0,0
AIDA Service,0,0,0,0,0,0,0
Trifid,0,0,0,0,0,0,0
DarcMatter,0,0,0,0,0,0,0
Signals,0,0,0,0,0,0,0
Oyster Shell,0,0,0,0,0,0,0
CashBag,0,0,0,0,0,0,0
Viola,34,35,20,89,38.20224719101123,39.325842696629216,22.47191011235955
Cappasity,0,0,0,0,0,0,0
PHI,102,31,59,192,53.125,16.145833333333336,30.729166666666668
Biograffi,0,0,0,0,0,0,0
Gluon,0,0,0,0,0,0,0
Fishcoin,0,0,0,0,0,0,0
BZLcoin,0,0,0,0,0,0,0
A2B Taxi,0,0,0,0,0,0,0
Monanex,0,0,0,0,0,0,0
Gladius,0,0,0,0,0,0,0
Elementh,0,0,0,0,0,0,0
Callisto,0,0,0,0,0,0,0
CIBUS,0,0,0,0,0,0,0
ConnectJob,0,0,0,0,0,0,0
BitNautic,0,0,0,0,0,0,0
WOTER,0,0,0,0,0,0,0
Ethearnal,0,0,0,0,0,0,0
Bitcore,0,0,0,0,0,0,0
Game Loot Network,0,0,0,0,0,0,0
MyDFS,0,0,0,0,0,0,0
Semux,0,0,0,0,0,0,0
Storweey,0,0,0,0,0,0,0
WAR FIELD,0,0,0,0,0,0,0
Leonardian,0,0,0,0,0,0,0
Cornucopia,1,0,0,1,100.0,0.0,0.0
Tutellus,0,0,0,0,0,0,0
Corl,0,0,0,0,0,0,0
Prandex,0,0,0,0,0,0,0
Dizcovery Network,0,0,0,0,0,0,0
BlockFollow,0,0,0,0,0,0,0
webRunes,0,0,0,0,0,0,0
Invest in Brokers,0,0,0,0,0,0,0
ApolloChain,0,0,0,0,0,0,0
uRunIt,0,0,0,0,0,0,0
AllStocks,0,0,0,0,0,0,0
