airdrop_name,positive,neutral,negative,total,positive_percentage,neutral_percentage,negative_percentage
corridor finance,0,0,0,0,0.0,0.0,0.0
nyan heroes,2,0,0,2,100.0,0.0,0.0
cyber,13,1,13,27,48.148148148148145,3.7037037037037033,48.148148148148145
ouinex,0,0,0,0,0.0,0.0,0.0
zksync,68,20,48,136,50.0,14.705882352941178,35.294117647058826
dogs,23,13,49,85,27.058823529411764,15.294117647058824,57.647058823529406
pontem,0,0,0,0,0.0,0.0,0.0
ether.fi,3,1,2,6,50.0,16.666666666666664,33.33333333333333
ostium,0,0,0,0,0.0,0.0,0.0
ancient8,1,0,0,1,100.0,0.0,0.0
usual,34,27,37,98,34.69387755102041,27.55102040816326,37.755102040816325
blastup,4,0,2,6,66.66666666666666,0.0,33.33333333333333
base,115,115,214,444,25.900900900900904,25.900900900900904,48.1981981981982
reactor fusion,0,0,0,0,0.0,0.0,0.0
merkle trade,0,0,0,0,0.0,0.0,0.0
pancakeswap,4,11,38,53,7.547169811320755,20.754716981132077,71.69811320754717
myx,9,2,9,20,45.0,10.0,45.0
ibx,2,4,16,22,9.090909090909092,18.181818181818183,72.72727272727273
texture,11,15,2,28,39.285714285714285,53.57142857142857,7.142857142857142
vaultcraft,0,0,0,0,0.0,0.0,0.0
newtify,0,0,0,0,0.0,0.0,0.0
grass,15,19,25,59,25.423728813559322,32.20338983050847,42.3728813559322
lavarage,0,0,0,0,0.0,0.0,0.0
scroll,14,17,27,58,24.137931034482758,29.310344827586203,46.55172413793103
swords & dungeons,0,0,0,0,0.0,0.0,0.0
rain.fi,0,2,0,2,0.0,100.0,0.0
macaron,0,0,0,0,0.0,0.0,0.0
clone,8,10,22,40,20.0,25.0,55.00000000000001
symbiotic,5,2,1,8,62.5,25.0,12.5
superboring,0,0,0,0,0.0,0.0,0.0
mocaverse,0,0,0,0,0.0,0.0,0.0
allora,4,0,3,7,57.14285714285714,0.0,42.857142857142854
jupiter,4,1,0,5,80.0,20.0,0.0
kroma,4,0,1,5,80.0,0.0,20.0
amphor,0,0,0,0,0.0,0.0,0.0
li.fi,0,0,2,2,0.0,0.0,100.0
zkcandy,0,0,0,0,0.0,0.0,0.0
napier finance,0,0,0,0,0.0,0.0,0.0
gate.io,5,1,12,18,27.77777777777778,5.555555555555555,66.66666666666666
sunrise,1,0,4,5,20.0,0.0,80.0
debank,0,0,1,1,0.0,0.0,100.0
rage trade,0,0,0,0,0.0,0.0,0.0
zircuit,5,0,1,6,83.33333333333334,0.0,16.666666666666664
super champs,0,0,0,0,0.0,0.0,0.0
injera,4,0,2,6,66.66666666666666,0.0,33.33333333333333
predx,0,0,0,0,0.0,0.0,0.0
units,32,40,43,115,27.82608695652174,34.78260869565217,37.391304347826086
camp network,0,0,0,0,0.0,0.0,0.0
rivalz network,4,5,0,9,44.44444444444444,55.55555555555556,0.0
10k dex,1,0,1,2,50.0,0.0,50.0
squid,6,8,14,28,21.428571428571427,28.57142857142857,50.0
goat gaming,0,0,0,0,0.0,0.0,0.0
hybrid,30,11,13,54,55.55555555555556,20.37037037037037,24.074074074074073
lazyotter,0,0,0,0,0.0,0.0,0.0
zerion,1,0,0,1,100.0,0.0,0.0
chirp,2,7,6,15,13.333333333333334,46.666666666666664,40.0
zebra,5,3,2,10,50.0,30.0,20.0
ai gram,0,0,0,0,0.0,0.0,0.0
cog finance,0,0,0,0,0.0,0.0,0.0
stakestone,2,0,0,2,100.0,0.0,0.0
mantle,3,2,15,20,15.0,10.0,75.0
superposition,3,3,2,8,37.5,37.5,25.0
symmetry trade,0,0,0,0,0.0,0.0,0.0
adrena,0,0,0,0,0.0,0.0,0.0
movement,58,26,78,162,35.80246913580247,16.049382716049383,48.148148148148145
nx finance,0,0,0,0,0.0,0.0,0.0
superposition finance,0,0,0,0,0.0,0.0,0.0
ora,2,2,3,7,28.57142857142857,28.57142857142857,42.857142857142854
gammaswap,0,0,0,0,0.0,0.0,0.0
unite,2,1,6,9,22.22222222222222,11.11111111111111,66.66666666666666
shardeum,0,0,0,0,0.0,0.0,0.0
echelon,0,0,2,2,0.0,0.0,100.0
rho markets,0,0,1,1,0.0,0.0,100.0
rainbow,21,1,5,27,77.77777777777779,3.7037037037037033,18.51851851851852
zeta,0,4,3,7,0.0,57.14285714285714,42.857142857142854
optopia,0,0,1,1,0.0,0.0,100.0
blast,26,13,22,61,42.62295081967213,21.311475409836063,36.0655737704918
zeek network,0,0,0,0,0.0,0.0,0.0
summer.fi,0,2,3,5,0.0,40.0,60.0
infinex,0,0,1,1,0.0,0.0,100.0
mitosis,1,1,2,4,25.0,25.0,50.0
sophon,0,0,0,0,0.0,0.0,0.0
voi network,1,0,3,4,25.0,0.0,75.0
nftperp,0,4,7,11,0.0,36.36363636363637,63.63636363636363
hyperlane,1,0,0,1,100.0,0.0,0.0
nuri exchange,0,0,0,0,0.0,0.0,0.0
f(x) protocol,0,0,0,0,0.0,0.0,0.0
the backwoods,0,0,0,0,0.0,0.0,0.0
kinetix finance,0,0,0,0,0.0,0.0,0.0
binance,108,56,210,374,28.87700534759358,14.973262032085561,56.14973262032086
layerzero,0,0,0,0,0.0,0.0,0.0
eigenlayer,5,2,5,12,41.66666666666667,16.666666666666664,41.66666666666667
vest,8,5,3,16,50.0,31.25,18.75
koi finance,1,0,0,1,100.0,0.0,0.0
100x,32,8,50,90,35.55555555555556,8.88888888888889,55.55555555555556
degen war$,0,0,0,0,0.0,0.0,0.0
cherry,15,4,11,30,50.0,13.333333333333334,36.666666666666664
zest protocol,3,0,0,3,100.0,0.0,0.0
catalyst,6,5,30,41,14.634146341463413,12.195121951219512,73.17073170731707
renzo,0,0,1,1,0.0,0.0,100.0
mercle,0,0,0,0,0.0,0.0,0.0
griffinai,3,0,0,3,100.0,0.0,0.0
captain & company,0,0,0,0,0.0,0.0,0.0
iotex,11,5,7,23,47.82608695652174,21.73913043478261,30.434782608695656
orderly network,1,0,0,1,100.0,0.0,0.0
sui,3,7,4,14,21.428571428571427,50.0,28.57142857142857
cochilli,0,0,0,0,0.0,0.0,0.0
fhenix,1,0,0,1,100.0,0.0,0.0
avantis,13,7,12,32,40.625,21.875,37.5
debridge,0,0,0,0,0.0,0.0,0.0
aethir,3,2,5,10,30.0,20.0,50.0
glyph,0,0,0,0,0.0,0.0,0.0
0xastra,0,0,0,0,0.0,0.0,0.0
sofa,11,9,8,28,39.285714285714285,32.142857142857146,28.57142857142857
taiko,1,3,0,4,25.0,75.0,0.0
revert,1,6,6,13,7.6923076923076925,46.15384615384615,46.15384615384615
nexis network,1,0,0,1,100.0,0.0,0.0
bitflow,2,0,5,7,28.57142857142857,0.0,71.42857142857143
kip protocol,1,0,0,1,100.0,0.0,0.0
dunes,12,9,4,25,48.0,36.0,16.0
biokript,1,0,0,1,100.0,0.0,0.0
d8x,0,0,0,0,0.0,0.0,0.0
fuel,21,14,30,65,32.30769230769231,21.53846153846154,46.15384615384615
rize,0,0,2,2,0.0,0.0,100.0
jigsaw,2,0,7,9,22.22222222222222,0.0,77.77777777777779
turtle club,5,2,3,10,50.0,20.0,30.0
rivo.xyz,0,0,0,0,0.0,0.0,0.0
gm network,0,0,0,0,0.0,0.0,0.0
pocket protector,1,1,0,2,50.0,50.0,0.0
olive network,0,0,1,1,0.0,0.0,100.0
zaros,3,6,3,12,25.0,50.0,25.0
avarik saga,0,0,0,0,0.0,0.0,0.0
forma,4,4,21,29,13.793103448275861,13.793103448275861,72.41379310344827
gaianet,0,0,0,0,0.0,0.0,0.0
alienx,0,0,1,1,0.0,0.0,100.0
hyperliquid,0,2,0,2,0.0,100.0,0.0
onchain,4,3,0,7,57.14285714285714,42.857142857142854,0.0
syrup,1,0,1,2,50.0,0.0,50.0
sender labs,0,0,0,0,0.0,0.0,0.0
ithaca protocol,0,0,0,0,0.0,0.0,0.0
marginly,0,0,0,0,0.0,0.0,0.0
anichess,0,0,0,0,0.0,0.0,0.0
equation,7,8,14,29,24.137931034482758,27.586206896551722,48.275862068965516
quantcheck,0,0,0,0,0.0,0.0,0.0
nekodex,0,0,2,2,0.0,0.0,100.0
solayer,18,2,1,21,85.71428571428571,9.523809523809524,4.761904761904762
fantasy top,0,0,0,0,0.0,0.0,0.0
anzen,0,0,0,0,0.0,0.0,0.0
evaa protocol,0,0,0,0,0.0,0.0,0.0
eigenpie,0,0,0,0,0.0,0.0,0.0
oasis ai,0,0,0,0,0.0,0.0,0.0
nexo,4,0,9,13,30.76923076923077,0.0,69.23076923076923
cex.io,9,11,31,51,17.647058823529413,21.568627450980394,60.78431372549019
pencils protocol,0,0,0,0,0.0,0.0,0.0
plume network,0,1,1,2,0.0,50.0,50.0
cryptopia,1,1,3,5,20.0,20.0,60.0
opengpu network,0,0,0,0,0.0,0.0,0.0
iskra,0,0,0,0,0.0,0.0,0.0
lingo,0,0,0,0,0.0,0.0,0.0
gravita protocol,2,2,0,4,50.0,50.0,0.0
initia,0,0,0,0,0.0,0.0,0.0
token metrics,0,0,0,0,0.0,0.0,0.0
gamium,4,0,2,6,66.66666666666666,0.0,33.33333333333333
agora,4,4,8,16,25.0,25.0,50.0
liquidium,0,0,0,0,0.0,0.0,0.0
autolayer,3,1,0,4,75.0,25.0,0.0
ethermail,0,0,1,1,0.0,0.0,100.0
vooi,0,0,1,1,0.0,0.0,100.0
lyra,0,1,1,2,0.0,50.0,50.0
tea,14,10,12,36,38.88888888888889,27.77777777777778,33.33333333333333
m2,2,1,2,5,40.0,20.0,40.0
eywa,6,7,7,20,30.0,35.0,35.0
delabs games,0,0,0,0,0.0,0.0,0.0
dwinity,0,0,0,0,0.0,0.0,0.0
thetanuts finance,0,0,0,0,0.0,0.0,0.0
world pvp,0,0,0,0,0.0,0.0,0.0
thruster,2,0,0,2,100.0,0.0,0.0
tari,0,0,0,0,0.0,0.0,0.0
imaginary ones,0,0,0,0,0.0,0.0,0.0
glacier network,0,0,0,0,0.0,0.0,0.0
zyfi,0,0,0,0,0.0,0.0,0.0
storm trade,0,0,0,0,0.0,0.0,0.0
phaver,0,0,0,0,0.0,0.0,0.0
elfin,0,0,0,0,0.0,0.0,0.0
masa,0,0,1,1,0.0,0.0,100.0
spacecatch,0,0,0,0,0.0,0.0,0.0
mande network,0,0,0,0,0.0,0.0,0.0
xtremeverse,2,1,2,5,40.0,20.0,40.0
fyde,0,1,1,2,0.0,50.0,50.0
ekubo,2,2,1,5,40.0,40.0,20.0
caga,0,0,0,0,0.0,0.0,0.0
sanctum,15,21,12,48,31.25,43.75,25.0
zkpass,1,0,0,1,100.0,0.0,0.0
my lovely planet,0,0,0,0,0.0,0.0,0.0
tabi,0,0,0,0,0.0,0.0,0.0
mode,66,76,68,210,31.428571428571427,36.19047619047619,32.38095238095238
particle network,1,0,0,1,100.0,0.0,0.0
xswap,0,0,0,0,0.0,0.0,0.0
zerolend,1,0,0,1,100.0,0.0,0.0
aperture finance,0,0,1,1,0.0,0.0,100.0
myth,8,9,31,48,16.666666666666664,18.75,64.58333333333334
immutable,3,9,40,52,5.769230769230769,17.307692307692307,76.92307692307693
drift protocol,0,0,0,0,0.0,0.0,0.0
another-1,0,0,0,0,0.0,0.0,0.0
raiinmaker,0,0,0,0,0.0,0.0,0.0
blackwing,11,2,7,20,55.00000000000001,10.0,35.0
kamino,4,1,3,8,50.0,12.5,37.5
saltwater games,1,0,0,1,100.0,0.0,0.0
uprock,5,0,1,6,83.33333333333334,0.0,16.666666666666664
lunarstorm,2,1,7,10,20.0,10.0,70.0
revolving games,0,0,0,0,0.0,0.0,0.0
planetquest,0,0,2,2,0.0,0.0,100.0
zoth,3,4,5,12,25.0,33.33333333333333,41.66666666666667
intentx,0,0,0,0,0.0,0.0,0.0
befi labs,0,0,0,0,0.0,0.0,0.0
reya network,0,0,0,0,0.0,0.0,0.0
moongate,0,0,0,0,0.0,0.0,0.0
pixelverse,0,0,0,0,0.0,0.0,0.0
apillon,0,0,0,0,0.0,0.0,0.0
bemo,0,0,0,0,0.0,0.0,0.0
milkyway,0,0,2,2,0.0,0.0,100.0
astaria,0,0,0,0,0.0,0.0,0.0
bsx,0,0,0,0,0.0,0.0,0.0
orangelayer,0,0,0,0,0.0,0.0,0.0
inceptionlrt,0,0,0,0,0.0,0.0,0.0
mantra,1,3,3,7,14.285714285714285,42.857142857142854,42.857142857142854
bouncebit,3,2,1,6,50.0,33.33333333333333,16.666666666666664
blastoff,1,2,1,4,25.0,50.0,25.0
soarchain,0,1,0,1,0.0,100.0,0.0
elixir,2,2,2,6,33.33333333333333,33.33333333333333,33.33333333333333
omni network,0,0,1,1,0.0,0.0,100.0
solv protocol,3,1,2,6,50.0,16.666666666666664,33.33333333333333
planet mojo,7,0,1,8,87.5,0.0,12.5
parcl,4,1,4,9,44.44444444444444,11.11111111111111,44.44444444444444
dtx,2,7,7,16,12.5,43.75,43.75
ultimate digits,0,0,0,0,0.0,0.0,0.0
mpro lab,0,0,0,0,0.0,0.0,0.0
tensor,1,3,3,7,14.285714285714285,42.857142857142854,42.857142857142854
pac finance,0,0,2,2,0.0,0.0,100.0
overtrip,0,0,0,0,0.0,0.0,0.0
blockgames,1,0,0,1,100.0,0.0,0.0
warden protocol,0,0,0,0,0.0,0.0,0.0
base name service,0,0,0,0,0.0,0.0,0.0
scallop,0,0,1,1,0.0,0.0,100.0
synfutures,0,0,0,0,0.0,0.0,0.0
starrynift,3,0,2,5,60.0,0.0,40.0
wormhole,4,3,2,9,44.44444444444444,33.33333333333333,22.22222222222222
hava coin,0,1,0,1,0.0,100.0,0.0
battle showdown: gambit,0,0,0,0,0.0,0.0,0.0
ethena,5,1,2,8,62.5,12.5,25.0
data ownership protocol,3,0,1,4,75.0,0.0,25.0
pryzm,1,0,3,4,25.0,0.0,75.0
coti,0,0,0,0,0.0,0.0,0.0
a51,0,0,0,0,0.0,0.0,0.0
zke exchange,0,0,0,0,0.0,0.0,0.0
sharpe,6,5,5,16,37.5,31.25,31.25
aries markets,0,0,0,0,0.0,0.0,0.0
elys network,0,1,1,2,0.0,50.0,50.0
haven1,0,0,0,0,0.0,0.0,0.0
helix,14,8,13,35,40.0,22.857142857142858,37.142857142857146
kelp dao,1,0,1,2,50.0,0.0,50.0
myswap,0,1,1,2,0.0,50.0,50.0
braavos,0,0,0,0,0.0,0.0,0.0
tortuga finance,0,0,0,0,0.0,0.0,0.0
bnb chain,3,2,2,7,42.857142857142854,28.57142857142857,28.57142857142857
aptin finance,0,0,0,0,0.0,0.0,0.0
unirouter,2,0,0,2,100.0,0.0,0.0
bitget wallet,15,4,2,21,71.42857142857143,19.047619047619047,9.523809523809524
aptos,2,4,1,7,28.57142857142857,57.14285714285714,14.285714285714285
beoble,0,0,0,0,0.0,0.0,0.0
param gaming,2,0,0,2,100.0,0.0,0.0
xyro,0,0,0,0,0.0,0.0,0.0
plena,0,0,0,0,0.0,0.0,0.0
polyhedra network,4,0,0,4,100.0,0.0,0.0
dflow,2,0,1,3,66.66666666666666,0.0,33.33333333333333
zklend,0,0,0,0,0.0,0.0,0.0
defispot,2,0,2,4,50.0,0.0,50.0
boson protocol,0,0,0,0,0.0,0.0,0.0
metis,0,0,0,0,0.0,0.0,0.0
districtone,0,0,1,1,0.0,0.0,100.0
layer3,0,1,0,1,0.0,100.0,0.0
entangle,1,0,0,1,100.0,0.0,0.0
panther protocol,0,0,0,0,0.0,0.0,0.0
memecoin,7,1,4,12,58.333333333333336,8.333333333333332,33.33333333333333
teller,6,4,14,24,25.0,16.666666666666664,58.333333333333336
gomble games,0,0,0,0,0.0,0.0,0.0
parallel network,0,0,0,0,0.0,0.0,0.0
venom,4,3,4,11,36.36363636363637,27.27272727272727,36.36363636363637
synthr,0,0,0,0,0.0,0.0,0.0
wen exchange,0,0,0,0,0.0,0.0,0.0
yolo games,0,0,0,0,0.0,0.0,0.0
lava,3,3,9,15,20.0,20.0,60.0
invarch,0,0,0,0,0.0,0.0,0.0
kiloex,1,1,0,2,50.0,50.0,0.0
hana network,0,0,0,0,0.0,0.0,0.0
metastreet,1,1,0,2,50.0,50.0,0.0
nulink,3,0,2,5,60.0,0.0,40.0
ambit finance,1,1,1,3,33.33333333333333,33.33333333333333,33.33333333333333
smart layer,0,0,0,0,0.0,0.0,0.0
mon protocol,0,0,1,1,0.0,0.0,100.0
rio network,0,0,0,0,0.0,0.0,0.0
optimism,9,6,16,31,29.03225806451613,19.35483870967742,51.61290322580645
blaster,2,0,0,2,100.0,0.0,0.0
starknet,6,5,1,12,50.0,41.66666666666667,8.333333333333332
altlayer,1,0,0,1,100.0,0.0,0.0
pixels,2,4,8,14,14.285714285714285,28.57142857142857,57.14285714285714
aftermath finance,0,0,0,0,0.0,0.0,0.0
avnu,1,0,1,2,50.0,0.0,50.0
bluefin,14,8,5,27,51.85185185185185,29.629629629629626,18.51851851851852
overlay protocol,0,0,0,0,0.0,0.0,0.0
claystack,2,0,0,2,100.0,0.0,0.0
retro bridge,0,0,0,0,0.0,0.0,0.0
dymension,1,1,0,2,50.0,50.0,0.0
init capital,0,0,0,0,0.0,0.0,0.0
bâ² network,0,0,0,0,0.0,0.0,0.0
pike,1,2,0,3,33.33333333333333,66.66666666666666,0.0
zetachain,1,0,0,1,100.0,0.0,0.0
partisia blockchain,0,0,0,0,0.0,0.0,0.0
aether,0,4,1,5,0.0,80.0,20.0
nostra,3,3,4,10,30.0,30.0,40.0
edexa,0,0,0,0,0.0,0.0,0.0
undeads,0,0,0,0,0.0,0.0,0.0
aether games,0,1,0,1,0.0,100.0,0.0
dmail network,0,0,0,0,0.0,0.0,0.0
presearch,3,1,1,5,60.0,20.0,20.0
bitcoin virtual machine,0,0,1,1,0.0,0.0,100.0
stackingdao,8,5,5,18,44.44444444444444,27.77777777777778,27.77777777777778
navi protocol,0,0,1,1,0.0,0.0,100.0
mind network,0,0,0,0,0.0,0.0,0.0
xion,0,0,0,0,0.0,0.0,0.0
ready to fight,0,0,0,0,0.0,0.0,0.0
brc-20 dex,0,0,0,0,0.0,0.0,0.0
web3go,0,0,0,0,0.0,0.0,0.0
eesee,0,0,0,0,0.0,0.0,0.0
unigraph protocol,0,0,0,0,0.0,0.0,0.0
virtual labs,0,0,0,0,0.0,0.0,0.0
manta network,0,0,0,0,0.0,0.0,0.0
sound.xyz,1,0,1,2,50.0,0.0,50.0
reveel,1,0,1,2,50.0,0.0,50.0
carv,0,0,1,1,0.0,0.0,100.0
swell,3,5,2,10,30.0,50.0,20.0
frame,30,29,39,98,30.612244897959183,29.591836734693878,39.795918367346935
teleportdao,3,0,2,5,60.0,0.0,40.0
seamless protocol,0,0,0,0,0.0,0.0,0.0
brc20,0,0,1,1,0.0,0.0,100.0
kinza finance,0,0,0,0,0.0,0.0,0.0
elusiv,1,1,2,4,25.0,25.0,50.0
marinade,3,0,1,4,75.0,0.0,25.0
jito,0,0,0,0,0.0,0.0,0.0
term structure,2,1,3,6,33.33333333333333,16.666666666666664,50.0
hinkal,0,0,0,0,0.0,0.0,0.0
patex,0,0,0,0,0.0,0.0,0.0
pyth network,0,0,0,0,0.0,0.0,0.0
meuna,1,0,0,1,100.0,0.0,0.0
satori,0,0,0,0,0.0,0.0,0.0
marginfi,2,1,0,3,66.66666666666666,33.33333333333333,0.0
scroll name service,0,0,0,0,0.0,0.0,0.0
aori,0,0,2,2,0.0,0.0,100.0
grvt,1,0,0,1,100.0,0.0,0.0
shanhai,1,2,2,5,20.0,40.0,40.0
tezos domains,0,0,0,0,0.0,0.0,0.0
derivio,0,0,1,1,0.0,0.0,100.0
celestia,2,4,3,9,22.22222222222222,44.44444444444444,33.33333333333333
bluelight,0,0,0,0,0.0,0.0,0.0
forcefi,0,0,0,0,0.0,0.0,0.0
juice,8,3,11,22,36.36363636363637,13.636363636363635,50.0
karak,14,5,7,26,53.84615384615385,19.230769230769234,26.923076923076923
redstone,2,0,1,3,66.66666666666666,0.0,33.33333333333333
okx,6,0,5,11,54.54545454545454,0.0,45.45454545454545
mangrove,4,2,0,6,66.66666666666666,33.33333333333333,0.0
altitude,1,2,5,8,12.5,25.0,62.5
ambient,4,0,0,4,100.0,0.0,0.0
connext,1,1,1,3,33.33333333333333,33.33333333333333,33.33333333333333
okto x quickswap,0,0,0,0,0.0,0.0,0.0
clipper,1,2,1,4,25.0,50.0,25.0
moonlandmeta,0,0,0,0,0.0,0.0,0.0
basilisk,2,9,5,16,12.5,56.25,31.25
lightlink,3,0,4,7,42.857142857142854,0.0,57.14285714285714
extra finance,0,1,2,3,0.0,33.33333333333333,66.66666666666666
chainflip,2,3,0,5,40.0,60.0,0.0
web3eco,0,0,0,0,0.0,0.0,0.0
hubble exchange,0,0,0,0,0.0,0.0,0.0
hmx,6,8,4,18,33.33333333333333,44.44444444444444,22.22222222222222
meld,1,1,0,2,50.0,50.0,0.0
worldcoin,6,2,7,15,40.0,13.333333333333334,46.666666666666664
dx25,0,0,0,0,0.0,0.0,0.0
tsunami finance,1,1,2,4,25.0,25.0,50.0
tapiocadao,0,0,0,0,0.0,0.0,0.0
archway,0,0,0,0,0.0,0.0,0.0
zksync id,0,0,0,0,0.0,0.0,0.0
polygon zkevm,0,0,0,0,0.0,0.0,0.0
diva,0,4,0,4,0.0,100.0,0.0
vela exchange,2,0,0,2,100.0,0.0,0.0
letit,0,0,0,0,0.0,0.0,0.0
whitebit,0,0,0,0,0.0,0.0,0.0
maverick protocol,6,1,0,7,85.71428571428571,14.285714285714285,0.0
tevaera,0,0,0,0,0.0,0.0,0.0
velar,3,0,0,3,100.0,0.0,0.0
lunafi,0,0,0,0,0.0,0.0,0.0
dboe,0,0,0,0,0.0,0.0,0.0
range protocol,0,0,0,0,0.0,0.0,0.0
cedro finance,0,0,0,0,0.0,0.0,0.0
digifinex,1,0,0,1,100.0,0.0,0.0
bydfi,0,0,0,0,0.0,0.0,0.0
magic square,0,0,0,0,0.0,0.0,0.0
starknet id,0,0,0,0,0.0,0.0,0.0
aark digital,0,0,0,0,0.0,0.0,0.0
mufex,0,0,0,0,0.0,0.0,0.0
foxify,1,0,0,1,100.0,0.0,0.0
pulsechain,2,1,5,8,25.0,12.5,62.5
housebets.io,1,0,0,1,100.0,0.0,0.0
dexcheck,0,0,0,0,0.0,0.0,0.0
rebel bots,0,0,2,2,0.0,0.0,100.0
hord,0,0,12,12,0.0,0.0,100.0
cashmere,14,8,6,28,50.0,28.57142857142857,21.428571428571427
5irechain,0,0,0,0,0.0,0.0,0.0
zksync name service,0,0,0,0,0.0,0.0,0.0
yum yum,3,2,2,7,42.857142857142854,28.57142857142857,28.57142857142857
zkx,0,0,0,0,0.0,0.0,0.0
increment,0,1,3,4,0.0,25.0,75.0
the lost wallet,0,0,0,0,0.0,0.0,0.0
linea,11,3,5,19,57.89473684210527,15.789473684210526,26.31578947368421
polynomial protocol,0,0,0,0,0.0,0.0,0.0
syncswap,3,0,0,3,100.0,0.0,0.0
daoversal,0,0,0,0,0.0,0.0,0.0
velvet.capital,0,0,0,0,0.0,0.0,0.0
huma finance,1,0,0,1,100.0,0.0,0.0
snowcone,0,0,0,0,0.0,0.0,0.0
arbitrum,17,12,38,67,25.37313432835821,17.91044776119403,56.71641791044776
quasar,0,0,0,0,0.0,0.0,0.0
dune analytics,0,0,0,0,0.0,0.0,0.0
space id,0,0,0,0,0.0,0.0,0.0
legends of elysium,0,0,0,0,0.0,0.0,0.0
tide exchange,0,1,0,1,0.0,100.0,0.0
alienswap,0,0,1,1,0.0,0.0,100.0
zigzag,0,1,1,2,0.0,50.0,50.0
collab.land,2,2,11,15,13.333333333333334,13.333333333333334,73.33333333333333
nexon finance,0,0,0,0,0.0,0.0,0.0
ez finance,0,0,0,0,0.0,0.0,0.0
olive,0,3,4,7,0.0,42.857142857142854,57.14285714285714
enchanter finance,0,0,0,0,0.0,0.0,0.0
mayan,0,0,0,0,0.0,0.0,0.0
sudoswap,0,0,0,0,0.0,0.0,0.0
timeless,2,3,3,8,25.0,37.5,37.5
billionair,0,0,0,0,0.0,0.0,0.0
supraoracles,0,0,0,0,0.0,0.0,0.0
ipor,1,0,0,1,100.0,0.0,0.0
neptune mutual,0,0,0,0,0.0,0.0,0.0
nft3,3,0,0,3,100.0,0.0,0.0
demex,1,0,0,1,100.0,0.0,0.0
specular,0,0,0,0,0.0,0.0,0.0
hashstack,0,0,0,0,0.0,0.0,0.0
brine,6,3,5,14,42.857142857142854,21.428571428571427,35.714285714285715
v2x,6,3,3,12,50.0,25.0,25.0
supernova,1,0,2,3,33.33333333333333,0.0,66.66666666666666
bebop,0,0,0,0,0.0,0.0,0.0
kwiktrust,2,0,0,2,100.0,0.0,0.0
phi,2,2,0,4,50.0,50.0,0.0
plenty,104,83,198,385,27.01298701298701,21.558441558441558,51.42857142857142
swing,8,12,36,56,14.285714285714285,21.428571428571427,64.28571428571429
spectrum finance,0,0,0,0,0.0,0.0,0.0
harbor protocol,0,0,0,0,0.0,0.0,0.0
sentiment,9,15,46,70,12.857142857142856,21.428571428571427,65.71428571428571
vertex,0,0,0,0,0.0,0.0,0.0
voltz,8,3,4,15,53.333333333333336,20.0,26.666666666666668
objkt.com,2,3,5,10,20.0,30.0,50.0
titi protocol,0,0,0,0,0.0,0.0,0.0
jediswap,0,0,0,0,0.0,0.0,0.0
uniswap,16,12,28,56,28.57142857142857,21.428571428571427,50.0
across,154,96,164,414,37.19806763285024,23.18840579710145,39.61352657004831
mean finance,0,0,0,0,0.0,0.0,0.0
key app,2,0,1,3,66.66666666666666,0.0,33.33333333333333
paraspace,0,0,0,0,0.0,0.0,0.0
layerswap,3,2,1,6,50.0,33.33333333333333,16.666666666666664
aboard,1,3,1,5,20.0,60.0,20.0
mun,0,0,4,4,0.0,0.0,100.0
via protocol,0,0,0,0,0.0,0.0,0.0
chainhop,0,0,0,0,0.0,0.0,0.0
cega,0,0,0,0,0.0,0.0,0.0
wombat,9,1,5,15,60.0,6.666666666666667,33.33333333333333
mtg,10,6,21,37,27.027027027027028,16.216216216216218,56.75675675675676
arrakis finance,0,0,0,0,0.0,0.0,0.0
dolomite,1,2,6,9,11.11111111111111,22.22222222222222,66.66666666666666
deepwaters,0,0,0,0,0.0,0.0,0.0
bluemove,0,0,0,0,0.0,0.0,0.0
optifi,0,0,0,0,0.0,0.0,0.0
alpha road,0,0,0,0,0.0,0.0,0.0
sei,6,14,21,41,14.634146341463413,34.146341463414636,51.21951219512195
openchat,0,0,1,1,0.0,0.0,100.0
rabbitx,1,0,0,1,100.0,0.0,0.0
the granary,1,1,5,7,14.285714285714285,14.285714285714285,71.42857142857143
metaplex,0,1,0,1,0.0,100.0,0.0
tectum,0,0,0,0,0.0,0.0,0.0
onomy protocol,0,0,0,0,0.0,0.0,0.0
blur,8,4,3,15,53.333333333333336,26.666666666666668,20.0
trustless,8,8,25,41,19.51219512195122,19.51219512195122,60.97560975609756
verida,4,1,1,6,66.66666666666666,16.666666666666664,16.666666666666664
xai,0,1,0,1,0.0,100.0,0.0
commodo,4,1,10,15,26.666666666666668,6.666666666666667,66.66666666666666
stratos,1,1,0,2,50.0,50.0,0.0
teritori,0,0,0,0,0.0,0.0,0.0
xen crypto,0,0,0,0,0.0,0.0,0.0
binance account bound (bab),0,0,0,0,0.0,0.0,0.0
zkex,0,0,0,0,0.0,0.0,0.0
helio protocol,16,0,4,20,80.0,0.0,20.0
karate combat,0,0,0,0,0.0,0.0,0.0
conic finance,0,0,0,0,0.0,0.0,0.0
htx,2,0,3,5,40.0,0.0,60.0
odos,0,0,0,0,0.0,0.0,0.0
ragnar protocol,0,0,0,0,0.0,0.0,0.0
allstars digital,0,0,0,0,0.0,0.0,0.0
kucoin,40,10,22,72,55.55555555555556,13.88888888888889,30.555555555555557
xiroverse,0,0,0,0,0.0,0.0,0.0
terran coin,0,0,0,0,0.0,0.0,0.0
quai network,0,0,0,0,0.0,0.0,0.0
dogechain,0,0,0,0,0.0,0.0,0.0
portal,16,4,17,37,43.24324324324324,10.81081081081081,45.94594594594595
cornerstone,1,0,0,1,100.0,0.0,0.0
stride,1,0,2,3,33.33333333333333,0.0,66.66666666666666
composable finance,0,0,1,1,0.0,0.0,100.0
strmnft,0,0,0,0,0.0,0.0,0.0
tegro,0,0,0,0,0.0,0.0,0.0
quix,2,3,2,7,28.57142857142857,42.857142857142854,28.57142857142857
bungee,0,0,1,1,0.0,0.0,100.0
stormgain,0,0,1,1,0.0,0.0,100.0
primex,0,0,0,0,0.0,0.0,0.0
tally ho,0,0,0,0,0.0,0.0,0.0
forta,0,0,0,0,0.0,0.0,0.0
sweat economy,0,0,0,0,0.0,0.0,0.0
zora,1,1,3,5,20.0,20.0,60.0
velodrome,1,0,0,1,100.0,0.0,0.0
chains,59,49,93,201,29.35323383084577,24.378109452736318,46.26865671641791
0vix,0,0,0,0,0.0,0.0,0.0
bonq,0,0,0,0,0.0,0.0,0.0
epsylon,2,1,0,3,66.66666666666666,33.33333333333333,0.0
ledn,2,0,0,2,100.0,0.0,0.0
realme,0,0,0,0,0.0,0.0,0.0
matrix,20,2,10,32,62.5,6.25,31.25
retrograde,0,0,0,0,0.0,0.0,0.0
hop protocol,1,0,0,1,100.0,0.0,0.0
gem,51,4,16,71,71.83098591549296,5.633802816901409,22.535211267605636
lend flare,0,1,0,1,0.0,100.0,0.0
armaldia,0,0,1,1,0.0,0.0,100.0
leap wallet,0,1,0,1,0.0,100.0,0.0
bridgesplit,1,0,0,1,100.0,0.0,0.0
fractional,5,2,9,16,31.25,12.5,56.25
nebula protocol,0,1,0,1,0.0,100.0,0.0
orbofi,1,0,0,1,100.0,0.0,0.0
styllar,5,0,0,5,100.0,0.0,0.0
crescent network,0,0,0,0,0.0,0.0,0.0
tangible,18,6,48,72,25.0,8.333333333333332,66.66666666666666
taki,0,2,4,6,0.0,33.33333333333333,66.66666666666666
iotube,4,2,2,8,50.0,25.0,25.0
yobit,0,1,0,1,0.0,100.0,0.0
void protocol,0,0,1,1,0.0,0.0,100.0
vinci,1,2,6,9,11.11111111111111,22.22222222222222,66.66666666666666
element finance,0,0,0,0,0.0,0.0,0.0
landdao,0,0,0,0,0.0,0.0,0.0
cheqd,0,0,1,1,0.0,0.0,100.0
dao labs,0,0,0,0,0.0,0.0,0.0
unagii,5,5,7,17,29.411764705882355,29.411764705882355,41.17647058823529
nested,7,5,10,22,31.818181818181817,22.727272727272727,45.45454545454545
assetmantle,4,0,6,10,40.0,0.0,60.0
morpher,0,0,0,0,0.0,0.0,0.0
limewire,1,0,1,2,50.0,0.0,50.0
mars protocol,0,0,0,0,0.0,0.0,0.0
findora,0,0,0,0,0.0,0.0,0.0
likecoin,0,0,0,0,0.0,0.0,0.0
fuji dao,0,0,0,0,0.0,0.0,0.0
diffusion finance,0,0,0,0,0.0,0.0,0.0
pstake finance,0,0,0,0,0.0,0.0,0.0
partybid,0,0,0,0,0.0,0.0,0.0
frax,0,2,1,3,0.0,66.66666666666666,33.33333333333333
craft economy,0,0,0,0,0.0,0.0,0.0
x2y2,0,0,0,0,0.0,0.0,0.0
cowswap,0,0,0,0,0.0,0.0,0.0
orbiter finance,0,0,0,0,0.0,0.0,0.0
gameinfinity,1,0,0,1,100.0,0.0,0.0
katana,6,3,3,12,50.0,25.0,25.0
stargaze,1,0,6,7,14.285714285714285,0.0,85.71428571428571
trust domains,0,0,0,0,0.0,0.0,0.0
fraktal,0,0,2,2,0.0,0.0,100.0
votium,1,0,0,1,100.0,0.0,0.0
pika protocol,1,0,1,2,50.0,0.0,50.0
nomic,0,0,2,2,0.0,0.0,100.0
friktion,5,5,4,14,35.714285714285715,35.714285714285715,28.57142857142857
whalefin,0,0,0,0,0.0,0.0,0.0
sonic,5,9,8,22,22.727272727272727,40.909090909090914,36.36363636363637
quarry,1,1,0,2,50.0,50.0,0.0
omniflix,1,4,7,12,8.333333333333332,33.33333333333333,58.333333333333336
chic cow & bullzz,0,0,0,0,0.0,0.0,0.0
shell protocol,0,0,0,0,0.0,0.0,0.0
mintbase,0,0,0,0,0.0,0.0,0.0
legion network,0,0,0,0,0.0,0.0,0.0
rubicon,1,0,0,1,100.0,0.0,0.0
glow,11,4,5,20,55.00000000000001,20.0,25.0
coinhall,7,3,1,11,63.63636363636363,27.27272727272727,9.090909090909092
looksrare,0,0,0,0,0.0,0.0,0.0
stellarx,0,0,0,0,0.0,0.0,0.0
coreum,0,0,0,0,0.0,0.0,0.0
gas dao,0,0,0,0,0.0,0.0,0.0
astroport,29,1,1,31,93.54838709677419,3.225806451612903,3.225806451612903
aztec,0,0,2,2,0.0,0.0,100.0
terra name service,0,0,1,1,0.0,0.0,100.0
lum network,0,1,1,2,0.0,50.0,50.0
francium,0,2,1,3,0.0,66.66666666666666,33.33333333333333
icon,36,17,39,92,39.130434782608695,18.478260869565215,42.391304347826086
paras,0,0,1,1,0.0,0.0,100.0
iota,28,21,38,87,32.18390804597701,24.137931034482758,43.67816091954023
comdex,1,1,5,7,14.285714285714285,14.285714285714285,71.42857142857143
volmex,0,0,0,0,0.0,0.0,0.0
iexec,1,1,3,5,20.0,20.0,60.0
berachain,2,1,0,3,66.66666666666666,33.33333333333333,0.0
die last,0,0,0,0,0.0,0.0,0.0
rabby wallet,0,0,0,0,0.0,0.0,0.0
grindery,1,0,1,2,50.0,0.0,50.0
synonym,0,0,4,4,0.0,0.0,100.0
terra world,0,0,0,0,0.0,0.0,0.0
superfluid,0,0,0,0,0.0,0.0,0.0
hardcore fc,0,0,1,1,0.0,0.0,100.0
hedgehog markets,0,0,0,0,0.0,0.0,0.0
sablier,0,0,0,0,0.0,0.0,0.0
desmos,2,1,1,4,50.0,25.0,25.0
atrix,0,0,0,0,0.0,0.0,0.0
instrumental finance,0,0,0,0,0.0,0.0,0.0
tokensets,0,0,0,0,0.0,0.0,0.0
spintop,1,1,0,2,50.0,50.0,0.0
phantom,13,9,12,34,38.23529411764706,26.47058823529412,35.294117647058826
aquarius,1,0,0,1,100.0,0.0,0.0
saddle finance,0,0,0,0,0.0,0.0,0.0
dexguru,2,1,2,5,40.0,20.0,40.0
paraswap,0,0,4,4,0.0,0.0,100.0
matcha,1,0,0,1,100.0,0.0,0.0
solanart,2,0,0,2,100.0,0.0,0.0
foundation,64,26,114,204,31.372549019607842,12.745098039215685,55.88235294117647
digital arms,0,0,0,0,0.0,0.0,0.0
gro protocol,1,0,0,1,100.0,0.0,0.0
gridlock,0,0,1,1,0.0,0.0,100.0
paladin,4,4,4,12,33.33333333333333,33.33333333333333,33.33333333333333
apricot finance,0,0,0,0,0.0,0.0,0.0
sologenic,0,0,0,0,0.0,0.0,0.0
terrafloki,0,0,0,0,0.0,0.0,0.0
defi saver,0,1,0,1,0.0,100.0,0.0
oneof,2,1,9,12,16.666666666666664,8.333333333333332,75.0
bityard,0,0,0,0,0.0,0.0,0.0
zapper,1,1,0,2,50.0,50.0,0.0
human protocol,0,0,0,0,0.0,0.0,0.0
gaia everworld,0,0,1,1,0.0,0.0,100.0
sportemon go,0,0,0,0,0.0,0.0,0.0
yield protocol,0,0,0,0,0.0,0.0,0.0
cozy finance,0,0,1,1,0.0,0.0,100.0
timeswap,1,0,0,1,100.0,0.0,0.0
terra land,0,0,0,0,0.0,0.0,0.0
opyn,0,0,0,0,0.0,0.0,0.0
symmetry,3,5,0,8,37.5,62.5,0.0
apollo dao,1,1,2,4,25.0,25.0,50.0
solend,2,0,0,2,100.0,0.0,0.0
terraswap,3,1,8,12,25.0,8.333333333333332,66.66666666666666
talis protocol,2,0,1,3,66.66666666666666,0.0,33.33333333333333
flare finance,0,0,0,0,0.0,0.0,0.0
polymarket,0,0,0,0,0.0,0.0,0.0
valkyrie protocol,0,0,0,0,0.0,0.0,0.0
slingshot,0,0,0,0,0.0,0.0,0.0
opensea,9,1,19,29,31.03448275862069,3.4482758620689653,65.51724137931035
shade protocol,0,0,1,1,0.0,0.0,100.0
roco finance,0,0,0,0,0.0,0.0,0.0
backd,0,0,0,0,0.0,0.0,0.0
loop,37,30,36,103,35.92233009708738,29.126213592233007,34.95145631067961
metamask,51,17,72,140,36.42857142857142,12.142857142857142,51.42857142857142
nexus protocol,1,0,0,1,100.0,0.0,0.0
boba network,0,0,0,0,0.0,0.0,0.0
portuma,1,0,1,2,50.0,0.0,50.0
brightid,2,0,0,2,100.0,0.0,0.0
inpoker,0,0,0,0,0.0,0.0,0.0
adshares,0,0,0,0,0.0,0.0,0.0
thales,0,1,0,1,0.0,100.0,0.0
foil network,0,0,0,0,0.0,0.0,0.0
songbird,0,0,1,1,0.0,0.0,100.0
tokel,0,0,0,0,0.0,0.0,0.0
bullionfx,0,0,4,4,0.0,0.0,100.0
juno,14,5,24,43,32.55813953488372,11.627906976744185,55.81395348837209
bitget,40,8,5,53,75.47169811320755,15.09433962264151,9.433962264150944
remitano,0,0,0,0,0.0,0.0,0.0
angel protocol,0,0,0,0,0.0,0.0,0.0
starterra,29,2,4,35,82.85714285714286,5.714285714285714,11.428571428571429
blockasset,0,0,0,0,0.0,0.0,0.0
superrare,0,0,0,0,0.0,0.0,0.0
hai damo,0,0,2,2,0.0,0.0,100.0
sunny,5,4,4,13,38.46153846153847,30.76923076923077,30.76923076923077
weyu,4,1,4,9,44.44444444444444,11.11111111111111,44.44444444444444
dydx,3,3,3,9,33.33333333333333,33.33333333333333,33.33333333333333
dfyn,0,0,0,0,0.0,0.0,0.0
notional,0,0,0,0,0.0,0.0,0.0
altair,0,0,0,0,0.0,0.0,0.0
shapeshift,0,0,0,0,0.0,0.0,0.0
thorswap,3,0,1,4,75.0,0.0,25.0
voltnft,0,0,0,0,0.0,0.0,0.0
openocean,0,0,0,0,0.0,0.0,0.0
nftb,0,0,0,0,0.0,0.0,0.0
hi,164,39,186,389,42.159383033419026,10.025706940874036,47.81491002570694
tap,21,28,33,82,25.609756097560975,34.146341463414636,40.243902439024396
moonbet,0,0,0,0,0.0,0.0,0.0
spar finance,0,0,0,0,0.0,0.0,0.0
connect financial,0,0,1,1,0.0,0.0,100.0
osmosis,11,12,30,53,20.754716981132077,22.641509433962266,56.60377358490566
pylon protocol,26,0,0,26,100.0,0.0,0.0
gembites,0,0,0,0,0.0,0.0,0.0
earnbet,2,0,0,2,100.0,0.0,0.0
orion money,2,1,2,5,40.0,20.0,40.0
omni,1,2,4,7,14.285714285714285,28.57142857142857,57.14285714285714
emiswap,0,0,0,0,0.0,0.0,0.0
crd network,0,0,0,0,0.0,0.0,0.0
instadapp,0,0,0,0,0.0,0.0,0.0
degenâs farm,0,0,0,0,0.0,0.0,0.0
blockster,0,0,0,0,0.0,0.0,0.0
skyward finance,0,0,0,0,0.0,0.0,0.0
moonedge,9,1,0,10,90.0,10.0,0.0
neftipedia,0,0,0,0,0.0,0.0,0.0
thorstarter,0,0,0,0,0.0,0.0,0.0
arweave,1,0,3,4,25.0,0.0,75.0
apenft,2,1,10,13,15.384615384615385,7.6923076923076925,76.92307692307693
easybake,0,0,0,0,0.0,0.0,0.0
honeyswap,0,0,1,1,0.0,0.0,100.0
charged particles,0,0,0,0,0.0,0.0,0.0
bartertrade,0,0,0,0,0.0,0.0,0.0
ribbon finance,0,0,0,0,0.0,0.0,0.0
zoidpay,2,0,2,4,50.0,0.0,50.0
qiswap,0,0,0,0,0.0,0.0,0.0
crypto thrills,0,0,0,0,0.0,0.0,0.0
doren,4,1,0,5,80.0,20.0,0.0
solpad,2,2,11,15,13.333333333333334,13.333333333333334,73.33333333333333
convex finance,0,0,0,0,0.0,0.0,0.0
runnode,0,0,0,0,0.0,0.0,0.0
venus,4,1,1,6,66.66666666666666,16.666666666666664,16.666666666666664
chainx,0,0,0,0,0.0,0.0,0.0
revuto,0,0,0,0,0.0,0.0,0.0
solanium,0,0,0,0,0.0,0.0,0.0
impermax finance,0,0,0,0,0.0,0.0,0.0
avalaunch,3,2,7,12,25.0,16.666666666666664,58.333333333333336
etherlite,5,4,6,15,33.33333333333333,26.666666666666668,40.0
badger dao,0,0,0,0,0.0,0.0,0.0
deversifi,0,0,0,0,0.0,0.0,0.0
bribe,1,1,13,15,6.666666666666667,6.666666666666667,86.66666666666667
sora,0,0,2,2,0.0,0.0,100.0
maiar exchange,0,0,0,0,0.0,0.0,0.0
hopr,0,0,0,0,0.0,0.0,0.0
aladdin,1,0,2,3,33.33333333333333,0.0,66.66666666666666
klomp,0,0,0,0,0.0,0.0,0.0
nftmart,0,0,1,1,0.0,0.0,100.0
lotto,3,1,2,6,50.0,16.666666666666664,33.33333333333333
1inch,3,1,0,4,75.0,25.0,0.0
affine,5,6,14,25,20.0,24.0,56.00000000000001
novadex,0,0,0,0,0.0,0.0,0.0
futureverse,0,0,0,0,0.0,0.0,0.0
script network,0,0,0,0,0.0,0.0,0.0
secret network,2,0,1,3,66.66666666666666,0.0,33.33333333333333
hydra,6,3,10,19,31.57894736842105,15.789473684210526,52.63157894736842
my lotto coin,0,0,0,0,0.0,0.0,0.0
anchor protocol,30,3,1,34,88.23529411764706,8.823529411764707,2.941176470588235
graphene,0,0,0,0,0.0,0.0,0.0
utile network,0,0,0,0,0.0,0.0,0.0
donnie finance,0,0,0,0,0.0,0.0,0.0
sperax,0,0,0,0,0.0,0.0,0.0
pooltogether,0,0,0,0,0.0,0.0,0.0
sifchain,0,0,0,0,0.0,0.0,0.0
neutrino protocol,0,0,0,0,0.0,0.0,0.0
bounce,12,14,43,69,17.391304347826086,20.28985507246377,62.31884057971014
invest & hodl,0,0,0,0,0.0,0.0,0.0
furucombo,0,0,0,0,0.0,0.0,0.0
lido,5,1,4,10,50.0,10.0,40.0
chainge,2,0,0,2,100.0,0.0,0.0
onx finance,2,0,0,2,100.0,0.0,0.0
marcopolo protocol,3,0,0,3,100.0,0.0,0.0
phala network,0,0,0,0,0.0,0.0,0.0
mirror protocol,26,0,1,27,96.29629629629629,0.0,3.7037037037037033
numio,0,0,0,0,0.0,0.0,0.0
flare,7,6,12,25,28.000000000000004,24.0,48.0
socialgood,0,0,0,0,0.0,0.0,0.0
metex,0,0,0,0,0.0,0.0,0.0
tomochain,0,0,0,0,0.0,0.0,0.0
audius,0,0,1,1,0.0,0.0,100.0
swanfinance,1,0,0,1,100.0,0.0,0.0
plutus,1,1,2,4,25.0,25.0,50.0
dia,3,5,13,21,14.285714285714285,23.809523809523807,61.904761904761905
permission,3,12,39,54,5.555555555555555,22.22222222222222,72.22222222222221
massnet,0,1,0,1,0.0,100.0,0.0
symbol,16,9,18,43,37.2093023255814,20.930232558139537,41.86046511627907
bitcoin rhodium,0,0,0,0,0.0,0.0,0.0
intexcoin,0,0,0,0,0.0,0.0,0.0
gooddollar,0,0,0,0,0.0,0.0,0.0
arcs,5,0,3,8,62.5,0.0,37.5
defichain,0,1,2,3,0.0,33.33333333333333,66.66666666666666
cypherium,0,0,0,0,0.0,0.0,0.0
handshake,3,2,5,10,30.0,20.0,50.0
pcash,0,0,0,0,0.0,0.0,0.0
swissborg,2,0,3,5,40.0,0.0,60.0
uniworld,0,0,0,0,0.0,0.0,0.0
babb,0,0,0,0,0.0,0.0,0.0
bitribe,0,0,0,0,0.0,0.0,0.0
nowex,0,0,0,0,0.0,0.0,0.0
dao maker,0,0,0,0,0.0,0.0,0.0
escher,7,14,14,35,20.0,40.0,40.0
bitbns,0,0,0,0,0.0,0.0,0.0
ludena protocol,0,0,0,0,0.0,0.0,0.0
pointpay,4,1,10,15,26.666666666666668,6.666666666666667,66.66666666666666
just,3018,3125,6648,12791,23.59471503400829,24.431240716128528,51.974044249863184
relictum pro,0,0,0,0,0.0,0.0,0.0
storeum,2,0,2,4,50.0,0.0,50.0
stellarpayglobal,0,0,0,0,0.0,0.0,0.0
drk defi,0,0,0,0,0.0,0.0,0.0
two prime,0,1,1,2,0.0,50.0,50.0
pac global,0,0,0,0,0.0,0.0,0.0
funderone,0,0,0,0,0.0,0.0,0.0
azbi,2,0,1,3,66.66666666666666,0.0,33.33333333333333
storex,0,0,0,0,0.0,0.0,0.0
blockpass,0,0,0,0,0.0,0.0,0.0
xinfin,0,0,3,3,0.0,0.0,100.0
1xbit,0,0,0,0,0.0,0.0,0.0
vnt chain labs,0,0,0,0,0.0,0.0,0.0
icury,0,0,0,0,0.0,0.0,0.0
swapzone,0,0,0,0,0.0,0.0,0.0
tandem,2,0,4,6,33.33333333333333,0.0,66.66666666666666
jdx,4,1,3,8,50.0,12.5,37.5
global gaming,0,0,0,0,0.0,0.0,0.0
foodecent,0,0,0,0,0.0,0.0,0.0
noknok,0,0,1,1,0.0,0.0,100.0
minereum,0,0,0,0,0.0,0.0,0.0
unochain,3,0,0,3,100.0,0.0,0.0
social club rocks,0,0,0,0,0.0,0.0,0.0
kulap,12,3,3,18,66.66666666666666,16.666666666666664,16.666666666666664
petro,3,0,1,4,75.0,0.0,25.0
b one payment,0,0,1,1,0.0,0.0,100.0
personal wager,1,0,0,1,100.0,0.0,0.0
coalculus,0,0,0,0,0.0,0.0,0.0
beldex,0,0,0,0,0.0,0.0,0.0
dain,0,0,0,0,0.0,0.0,0.0
emirex,0,0,0,0,0.0,0.0,0.0
bitcoin turbo koin giveaway,0,0,0,0,0.0,0.0,0.0
bancor,6,1,6,13,46.15384615384615,7.6923076923076925,46.15384615384615
jil tokens,0,0,0,0,0.0,0.0,0.0
k-tune,0,0,2,2,0.0,0.0,100.0
ecxx,0,0,0,0,0.0,0.0,0.0
pockero,2,0,0,2,100.0,0.0,0.0
netspot solutions,0,0,0,0,0.0,0.0,0.0
limestone network,4,1,0,5,80.0,20.0,0.0
p2p club,0,0,0,0,0.0,0.0,0.0
bitcollar,1,0,1,2,50.0,0.0,50.0
lino network,0,0,0,0,0.0,0.0,0.0
brave new coin,0,0,0,0,0.0,0.0,0.0
wavesbet,0,0,0,0,0.0,0.0,0.0
riwigo,3,0,0,3,100.0,0.0,0.0
liquidapps,0,0,0,0,0.0,0.0,0.0
herocoin,1,0,1,2,50.0,0.0,50.0
blocbox,4,0,0,4,100.0,0.0,0.0
morpheus network,0,0,0,0,0.0,0.0,0.0
neo smart energy,0,0,2,2,0.0,0.0,100.0
stan world,1,0,2,3,33.33333333333333,0.0,66.66666666666666
tune.fm,6,4,17,27,22.22222222222222,14.814814814814813,62.96296296296296
swiftex,1,0,0,1,100.0,0.0,0.0
diagon,0,0,0,0,0.0,0.0,0.0
refork,0,0,0,0,0.0,0.0,0.0
apollo,19,13,17,49,38.775510204081634,26.53061224489796,34.69387755102041
cryptocells,0,0,2,2,0.0,0.0,100.0
freelanex,0,0,0,0,0.0,0.0,0.0
beowulf blockchain,0,0,1,1,0.0,0.0,100.0
freedomoptions,0,0,0,0,0.0,0.0,0.0
2key,0,0,0,0,0.0,0.0,0.0
crypto tribunal,0,0,0,0,0.0,0.0,0.0
troytrade,0,0,0,0,0.0,0.0,0.0
kappi,0,0,0,0,0.0,0.0,0.0
kuvacash,0,0,0,0,0.0,0.0,0.0
enod,0,0,0,0,0.0,0.0,0.0
cudos,0,0,1,1,0.0,0.0,100.0
bitquant,0,0,0,0,0.0,0.0,0.0
binance jex,0,0,0,0,0.0,0.0,0.0
yezcoin,1,1,0,2,50.0,50.0,0.0
validity,2,0,3,5,40.0,0.0,60.0
rif,0,0,0,0,0.0,0.0,0.0
medilives,0,0,0,0,0.0,0.0,0.0
ormeus ecosystem,0,0,0,0,0.0,0.0,0.0
inmining,0,0,0,0,0.0,0.0,0.0
nos initiative,0,0,0,0,0.0,0.0,0.0
maecenas,0,0,0,0,0.0,0.0,0.0
nova mining,0,0,0,0,0.0,0.0,0.0
project with,66,9,6,81,81.48148148148148,11.11111111111111,7.4074074074074066
adrenaline ai,0,0,0,0,0.0,0.0,0.0
hydro,2,1,5,8,25.0,12.5,62.5
oilwellcoin,2,0,0,2,100.0,0.0,0.0
pynk,0,0,0,0,0.0,0.0,0.0
gcox,0,0,0,0,0.0,0.0,0.0
cocos bcx,0,0,0,0,0.0,0.0,0.0
livetree,0,0,4,4,0.0,0.0,100.0
felixo,0,0,0,0,0.0,0.0,0.0
wink,5,1,5,11,45.45454545454545,9.090909090909092,45.45454545454545
telecoin,0,1,0,1,0.0,100.0,0.0
spockchain,0,0,0,0,0.0,0.0,0.0
arena match,0,0,0,0,0.0,0.0,0.0
discodery,0,0,0,0,0.0,0.0,0.0
qtum,1,2,1,4,25.0,50.0,25.0
netkoin,2,0,0,2,100.0,0.0,0.0
algorand,23,7,32,62,37.096774193548384,11.29032258064516,51.61290322580645
ten billion coin,0,0,0,0,0.0,0.0,0.0
ovr,3,1,0,4,75.0,25.0,0.0
bags token,0,0,0,0,0.0,0.0,0.0
allforcrypto,0,0,0,0,0.0,0.0,0.0
civic,13,12,26,51,25.49019607843137,23.52941176470588,50.98039215686274
komodo,1,0,2,3,33.33333333333333,0.0,66.66666666666666
netbox.global,1,0,0,1,100.0,0.0,0.0
brikcoin,2,0,0,2,100.0,0.0,0.0
piexgo,7,0,3,10,70.0,0.0,30.0
paramountdax,0,0,0,0,0.0,0.0,0.0
mediacoin,1,0,0,1,100.0,0.0,0.0
dusk network,0,0,0,0,0.0,0.0,0.0
counos platform,0,0,0,0,0.0,0.0,0.0
btcow,0,0,0,0,0.0,0.0,0.0
fio social,2,0,0,2,100.0,0.0,0.0
pbet,0,0,0,0,0.0,0.0,0.0
coincome,0,0,1,1,0.0,0.0,100.0
comno network,0,0,0,0,0.0,0.0,0.0
blaze protocol,0,0,0,0,0.0,0.0,0.0
genesis,11,14,46,71,15.492957746478872,19.718309859154928,64.7887323943662
doctailor,0,0,0,0,0.0,0.0,0.0
fortem capital,1,0,0,1,100.0,0.0,0.0
authoreon,0,0,0,0,0.0,0.0,0.0
ideafex,2,0,2,4,50.0,0.0,50.0
ubrica,0,0,0,0,0.0,0.0,0.0
typerium,1,0,0,1,100.0,0.0,0.0
vcc exchange,2,1,0,3,66.66666666666666,33.33333333333333,0.0
product protocol,0,0,0,0,0.0,0.0,0.0
ethplode,0,0,0,0,0.0,0.0,0.0
sdat,1,5,3,9,11.11111111111111,55.55555555555556,33.33333333333333
sparrow,0,0,0,0,0.0,0.0,0.0
anchor,47,13,22,82,57.3170731707317,15.853658536585366,26.82926829268293
creamcoin,4,1,0,5,80.0,20.0,0.0
cindx,0,0,0,0,0.0,0.0,0.0
atlas protocol,2,0,0,2,100.0,0.0,0.0
plasmapay,0,0,0,0,0.0,0.0,0.0
raven protocol,2,0,4,6,33.33333333333333,0.0,66.66666666666666
bcnex,16,0,3,19,84.21052631578947,0.0,15.789473684210526
triffic,0,0,0,0,0.0,0.0,0.0
cotrader,0,0,0,0,0.0,0.0,0.0
mimblewimblecoin,0,0,0,0,0.0,0.0,0.0
mimidi,2,0,0,2,100.0,0.0,0.0
globatalent,0,0,0,0,0.0,0.0,0.0
xprivate chat,0,0,0,0,0.0,0.0,0.0
homebloc,1,0,2,3,33.33333333333333,0.0,66.66666666666666
xr web,0,0,0,0,0.0,0.0,0.0
suku,0,0,0,0,0.0,0.0,0.0
diamdexx,0,0,0,0,0.0,0.0,0.0
ampleforth,0,0,0,0,0.0,0.0,0.0
minglechain,0,0,4,4,0.0,0.0,100.0
bitwings,0,0,0,0,0.0,0.0,0.0
uhive,0,0,0,0,0.0,0.0,0.0
tryvium,1,0,0,1,100.0,0.0,0.0
aibb,0,0,0,0,0.0,0.0,0.0
dukascoin,0,0,5,5,0.0,0.0,100.0
sixdomainchain,0,0,0,0,0.0,0.0,0.0
crypto market ads,0,0,0,0,0.0,0.0,0.0
universalcoin,0,0,0,0,0.0,0.0,0.0
p2ps,0,0,0,0,0.0,0.0,0.0
social chains,1,0,0,1,100.0,0.0,0.0
reserve round 2,0,0,0,0,0.0,0.0,0.0
dvmarketplace,0,0,0,0,0.0,0.0,0.0
bank of hodlers,0,0,0,0,0.0,0.0,0.0
opiria,0,0,0,0,0.0,0.0,0.0
kozjin,0,0,0,0,0.0,0.0,0.0
bullex,0,0,0,0,0.0,0.0,0.0
allsesame,0,0,0,0,0.0,0.0,0.0
fesschain,0,0,0,0,0.0,0.0,0.0
dayta,0,0,0,0,0.0,0.0,0.0
mindexcoin,0,0,0,0,0.0,0.0,0.0
grayll,1,0,0,1,100.0,0.0,0.0
ferrum network,1,0,0,1,100.0,0.0,0.0
ten,30,24,78,132,22.727272727272727,18.181818181818183,59.09090909090909
noia network,0,0,0,0,0.0,0.0,0.0
matrix ai network,0,0,0,0,0.0,0.0,0.0
amuse,0,1,0,1,0.0,100.0,0.0
mediconnect,0,0,0,0,0.0,0.0,0.0
bittube,0,1,0,1,0.0,100.0,0.0
authpaper,2,2,1,5,40.0,40.0,20.0
btscoin,0,0,2,2,0.0,0.0,100.0
coinhe,0,0,0,0,0.0,0.0,0.0
localcoin,0,0,0,0,0.0,0.0,0.0
stellarpay,0,0,0,0,0.0,0.0,0.0
iotw,0,0,0,0,0.0,0.0,0.0
cryptoxygen,0,0,0,0,0.0,0.0,0.0
cinemadrom,2,0,0,2,100.0,0.0,0.0
fusion coin,0,0,0,0,0.0,0.0,0.0
cbnt,0,1,0,1,0.0,100.0,0.0
odem,0,0,0,0,0.0,0.0,0.0
earthbi,2,0,0,2,100.0,0.0,0.0
venoty,2,0,0,2,100.0,0.0,0.0
futurepia,1,1,1,3,33.33333333333333,33.33333333333333,33.33333333333333
rtree,0,0,0,0,0.0,0.0,0.0
streamex,5,0,0,5,100.0,0.0,0.0
tipestry,0,0,0,0,0.0,0.0,0.0
betinance,0,0,0,0,0.0,0.0,0.0
bitforex,1,0,0,1,100.0,0.0,0.0
coinquista,0,0,0,0,0.0,0.0,0.0
amanpuri,0,0,0,0,0.0,0.0,0.0
atomic wallet,1,0,3,4,25.0,0.0,75.0
five colors coin,2,0,0,2,100.0,0.0,0.0
even foundation,0,0,0,0,0.0,0.0,0.0
konstellation,0,0,0,0,0.0,0.0,0.0
gemstra,0,0,0,0,0.0,0.0,0.0
chelle coin,1,0,0,1,100.0,0.0,0.0
pukkamex,3,0,0,3,100.0,0.0,0.0
avxchange,0,0,0,0,0.0,0.0,0.0
eden.best,0,0,0,0,0.0,0.0,0.0
licht project,0,0,1,1,0.0,0.0,100.0
trade nexi,0,0,0,0,0.0,0.0,0.0
openweb network,0,0,0,0,0.0,0.0,0.0
somesing,0,0,0,0,0.0,0.0,0.0
vite,5,6,4,15,33.33333333333333,40.0,26.666666666666668
madana,0,0,0,0,0.0,0.0,0.0
knowledge,115,58,156,329,34.954407294832826,17.62917933130699,47.41641337386018
block and chain,0,0,0,0,0.0,0.0,0.0
monarch,5,7,3,15,33.33333333333333,46.666666666666664,20.0
ally network,0,0,0,0,0.0,0.0,0.0
files.fm,1,0,0,1,100.0,0.0,0.0
terra credit,0,0,0,0,0.0,0.0,0.0
tangle,4,5,7,16,25.0,31.25,43.75
vecap,0,0,0,0,0.0,0.0,0.0
havaex,0,0,0,0,0.0,0.0,0.0
fst network,0,0,0,0,0.0,0.0,0.0
vodi x,0,0,0,0,0.0,0.0,0.0
quarkchain,0,0,1,1,0.0,0.0,100.0
purple butterfly trading,0,0,0,0,0.0,0.0,0.0
digitex,0,0,0,0,0.0,0.0,0.0
omnity,0,0,0,0,0.0,0.0,0.0
sheepcoin,4,0,0,4,100.0,0.0,0.0
quigig,4,0,1,5,80.0,0.0,20.0
uma,10,11,49,70,14.285714285714285,15.714285714285714,70.0
vine protocol,0,0,0,0,0.0,0.0,0.0
opensea traders,0,0,0,0,0.0,0.0,0.0
mofi finance,0,0,0,0,0.0,0.0,0.0
poap,3,0,1,4,75.0,0.0,25.0
moozicore,1,0,0,1,100.0,0.0,0.0
cryptosoul,3,0,4,7,42.857142857142854,0.0,57.14285714285714
nodis,3,0,0,3,100.0,0.0,0.0
solve.care,9,0,0,9,100.0,0.0,0.0
4hiphop,2,0,0,2,100.0,0.0,0.0
almeedex,0,0,0,0,0.0,0.0,0.0
saiterm,0,0,0,0,0.0,0.0,0.0
xcoynz,0,0,0,0,0.0,0.0,0.0
btcex,0,0,0,0,0.0,0.0,0.0
vanm,0,0,0,0,0.0,0.0,0.0
hyperionx,0,0,0,0,0.0,0.0,0.0
crypto potential,0,0,0,0,0.0,0.0,0.0
wowx,4,0,1,5,80.0,0.0,20.0
triipmiles,0,0,0,0,0.0,0.0,0.0
yellowtradingcoin,1,0,0,1,100.0,0.0,0.0
bluenote,2,2,0,4,50.0,50.0,0.0
cogmento,1,1,0,2,50.0,50.0,0.0
xpchain,1,0,4,5,20.0,0.0,80.0
kronn,1,0,0,1,100.0,0.0,0.0
glad network,0,0,0,0,0.0,0.0,0.0
thevault,0,0,0,0,0.0,0.0,0.0
cointiger,0,0,0,0,0.0,0.0,0.0
precium foundation,0,0,0,0,0.0,0.0,0.0
global cryptocurrency,0,0,0,0,0.0,0.0,0.0
z-pop dream,4,3,6,13,30.76923076923077,23.076923076923077,46.15384615384615
whirl,3,0,0,3,100.0,0.0,0.0
daily coin news,0,0,0,0,0.0,0.0,0.0
bittorrent,3,3,8,14,21.428571428571427,21.428571428571427,57.14285714285714
hxro,0,0,0,0,0.0,0.0,0.0
dacc,0,1,0,1,0.0,100.0,0.0
singh,0,0,2,2,0.0,0.0,100.0
pop network,0,0,0,0,0.0,0.0,0.0
mesg,1,0,0,1,100.0,0.0,0.0
dataonblock,0,0,0,0,0.0,0.0,0.0
proof of toss,0,0,0,0,0.0,0.0,0.0
terragreen,0,0,0,0,0.0,0.0,0.0
paxpago,1,0,0,1,100.0,0.0,0.0
afincoin,0,0,0,0,0.0,0.0,0.0
the collective,4,3,13,20,20.0,15.0,65.0
lto network,0,0,1,1,0.0,0.0,100.0
insights network,0,0,0,0,0.0,0.0,0.0
cloverdex,1,0,0,1,100.0,0.0,0.0
decentrax,1,0,0,1,100.0,0.0,0.0
volentix,7,0,1,8,87.5,0.0,12.5
energi,0,0,2,2,0.0,0.0,100.0
opu labs,2,0,0,2,100.0,0.0,0.0
sharemeall,0,0,0,0,0.0,0.0,0.0
mycryptobank,0,0,0,0,0.0,0.0,0.0
grailum lab,0,0,0,0,0.0,0.0,0.0
petchains,3,0,2,5,60.0,0.0,40.0
paradise token,1,1,1,3,33.33333333333333,33.33333333333333,33.33333333333333
game fanz,0,0,0,0,0.0,0.0,0.0
konkrete,0,0,0,0,0.0,0.0,0.0
klickzie,3,0,0,3,100.0,0.0,0.0
tradeplace,0,0,1,1,0.0,0.0,100.0
ares tech,0,0,0,0,0.0,0.0,0.0
hubrisone,0,0,0,0,0.0,0.0,0.0
perkscoin,0,0,0,0,0.0,0.0,0.0
sentivate,0,0,0,0,0.0,0.0,0.0
bitcoin confidential,3,0,1,4,75.0,0.0,25.0
dragonglass,0,0,0,0,0.0,0.0,0.0
thorchain,3,2,5,10,30.0,20.0,50.0
griffex,3,2,0,5,60.0,40.0,0.0
accumulus threat shield,0,0,0,0,0.0,0.0,0.0
earnet,0,0,0,0,0.0,0.0,0.0
mobilego,0,0,0,0,0.0,0.0,0.0
hotelload,0,0,0,0,0.0,0.0,0.0
dnn,0,0,0,0,0.0,0.0,0.0
playgroundz,1,0,1,2,50.0,0.0,50.0
bitsong,0,0,1,1,0.0,0.0,100.0
omnibazaar,0,0,0,0,0.0,0.0,0.0
inmax,0,0,0,0,0.0,0.0,0.0
platon finance,0,0,0,0,0.0,0.0,0.0
idap.io,6,0,3,9,66.66666666666666,0.0,33.33333333333333
levolution,0,0,0,0,0.0,0.0,0.0
bethereum,4,1,4,9,44.44444444444444,11.11111111111111,44.44444444444444
gamb,0,0,0,0,0.0,0.0,0.0
ice chain,2,8,1,11,18.181818181818183,72.72727272727273,9.090909090909092
pareto network,0,0,0,0,0.0,0.0,0.0
solarex,0,0,0,0,0.0,0.0,0.0
spectrum,12,16,13,41,29.268292682926827,39.02439024390244,31.70731707317073
faba,0,0,0,0,0.0,0.0,0.0
indochain,0,0,0,0,0.0,0.0,0.0
liquid (raffle),0,0,0,0,0.0,0.0,0.0
vegannation,0,0,0,0,0.0,0.0,0.0
dsion,0,0,0,0,0.0,0.0,0.0
tokenville,4,1,0,5,80.0,20.0,0.0
gooreo,0,0,0,0,0.0,0.0,0.0
populstay,0,0,0,0,0.0,0.0,0.0
uris,0,2,0,2,0.0,100.0,0.0
havven,1,1,0,2,50.0,50.0,0.0
cryptobonusmiles,0,0,0,0,0.0,0.0,0.0
jarvis,0,0,0,0,0.0,0.0,0.0
bancryp,2,0,0,2,100.0,0.0,0.0
medoctor,3,0,3,6,50.0,0.0,50.0
cubego,1,0,0,1,100.0,0.0,0.0
unification,0,0,2,2,0.0,0.0,100.0
mind ai,1,0,0,1,100.0,0.0,0.0
cures token,0,0,0,0,0.0,0.0,0.0
mobile token bank,0,0,0,0,0.0,0.0,0.0
goddex,5,2,4,11,45.45454545454545,18.181818181818183,36.36363636363637
springrole,0,0,0,0,0.0,0.0,0.0
securypto,0,1,4,5,0.0,20.0,80.0
dolla,0,0,0,0,0.0,0.0,0.0
tune token,0,0,0,0,0.0,0.0,0.0
v systems,0,0,0,0,0.0,0.0,0.0
ocnet,0,0,0,0,0.0,0.0,0.0
orbise,0,0,0,0,0.0,0.0,0.0
sonata.ai,2,0,0,2,100.0,0.0,0.0
phoneum,0,0,2,2,0.0,0.0,100.0
c2c,0,0,0,0,0.0,0.0,0.0
bitcanna,0,0,0,0,0.0,0.0,0.0
smart trade coin,0,0,0,0,0.0,0.0,0.0
wellmee,19,0,3,22,86.36363636363636,0.0,13.636363636363635
varius world tech,0,0,1,1,0.0,0.0,100.0
zensports,0,0,0,0,0.0,0.0,0.0
raido,0,0,0,0,0.0,0.0,0.0
biton,0,0,0,0,0.0,0.0,0.0
tokedo,0,0,0,0,0.0,0.0,0.0
unifox,0,0,0,0,0.0,0.0,0.0
one solution,2,3,1,6,33.33333333333333,50.0,16.666666666666664
pgf500,0,0,0,0,0.0,0.0,0.0
datafund,2,0,1,3,66.66666666666666,0.0,33.33333333333333
trippki,0,1,2,3,0.0,33.33333333333333,66.66666666666666
murmur,0,0,0,0,0.0,0.0,0.0
rewards,232,91,159,482,48.13278008298755,18.87966804979253,32.98755186721991
namacoin,0,0,0,0,0.0,0.0,0.0
the 4th pillar,0,0,0,0,0.0,0.0,0.0
qubay,0,0,0,0,0.0,0.0,0.0
socialremit,6,0,3,9,66.66666666666666,0.0,33.33333333333333
allive,0,0,0,0,0.0,0.0,0.0
clear foundation,0,0,0,0,0.0,0.0,0.0
thefund.io,0,0,0,0,0.0,0.0,0.0
qobit,0,0,0,0,0.0,0.0,0.0
gamo protocol,0,0,0,0,0.0,0.0,0.0
bitozz,1,0,0,1,100.0,0.0,0.0
nd invest,0,0,0,0,0.0,0.0,0.0
gg international,0,0,0,0,0.0,0.0,0.0
tradesprite,0,0,0,0,0.0,0.0,0.0
veryfile,17,1,1,19,89.47368421052632,5.263157894736842,5.263157894736842
temco,1,0,1,2,50.0,0.0,50.0
social note,0,0,0,0,0.0,0.0,0.0
xrp by huobi,0,0,0,0,0.0,0.0,0.0
x infinity,0,0,0,0,0.0,0.0,0.0
fanchain,1,1,2,4,25.0,25.0,50.0
fidelity house,0,0,0,0,0.0,0.0,0.0
bitcademy,0,0,0,0,0.0,0.0,0.0
fiiicoin,0,0,0,0,0.0,0.0,0.0
platin,0,0,0,0,0.0,0.0,0.0
hintchain,2,0,4,6,33.33333333333333,0.0,66.66666666666666
london block exchange,0,0,0,0,0.0,0.0,0.0
phoenix,12,8,11,31,38.70967741935484,25.806451612903224,35.483870967741936
athero,0,0,0,0,0.0,0.0,0.0
bitvalve,0,0,0,0,0.0,0.0,0.0
arcc,0,0,0,0,0.0,0.0,0.0
verity,0,0,0,0,0.0,0.0,0.0
belacam,0,0,0,0,0.0,0.0,0.0
blocpal,0,0,0,0,0.0,0.0,0.0
mindsync,0,0,0,0,0.0,0.0,0.0
velic,0,0,2,2,0.0,0.0,100.0
highbank,1,0,0,1,100.0,0.0,0.0
fortfc,0,0,0,0,0.0,0.0,0.0
curveblock,4,0,0,4,100.0,0.0,0.0
huddl,0,0,0,0,0.0,0.0,0.0
feedock,0,0,0,0,0.0,0.0,0.0
hara,8,0,1,9,88.88888888888889,0.0,11.11111111111111
vreo,0,0,0,0,0.0,0.0,0.0
hilynk,0,0,2,2,0.0,0.0,100.0
depository network,0,0,0,0,0.0,0.0,0.0
ellcrys,3,0,2,5,60.0,0.0,40.0
bitpanda,4,1,5,10,40.0,10.0,50.0
consensus,22,26,60,108,20.37037037037037,24.074074074074073,55.55555555555556
stox,0,0,0,0,0.0,0.0,0.0
mycro jobs,0,0,0,0,0.0,0.0,0.0
instant sponsor,0,0,0,0,0.0,0.0,0.0
gofind.world,0,0,0,0,0.0,0.0,0.0
minedblock,0,0,0,0,0.0,0.0,0.0
crypt-on,0,1,0,1,0.0,100.0,0.0
coinjax,0,0,0,0,0.0,0.0,0.0
lexit,1,0,0,1,100.0,0.0,0.0
aivon,0,0,0,0,0.0,0.0,0.0
archetypal network,0,0,0,0,0.0,0.0,0.0
b21,0,0,0,0,0.0,0.0,0.0
open packaging network,0,0,0,0,0.0,0.0,0.0
bistox exchange,0,0,0,0,0.0,0.0,0.0
fortknoxster,1,0,0,1,100.0,0.0,0.0
connecty,0,0,0,0,0.0,0.0,0.0
truwho,0,1,0,1,0.0,100.0,0.0
hydro protocol,0,0,0,0,0.0,0.0,0.0
kidbizo,0,0,0,0,0.0,0.0,0.0
sirin labs,0,0,0,0,0.0,0.0,0.0
get achieve,0,0,0,0,0.0,0.0,0.0
bright network,2,0,2,4,50.0,0.0,50.0
sentinel,7,4,14,25,28.000000000000004,16.0,56.00000000000001
certified diamond coin,3,0,0,3,100.0,0.0,0.0
idealcoin,0,0,0,0,0.0,0.0,0.0
gozo,0,0,0,0,0.0,0.0,0.0
smart refinery technologies,0,0,0,0,0.0,0.0,0.0
javvy,0,0,0,0,0.0,0.0,0.0
stayge,0,0,0,0,0.0,0.0,0.0
zulu republic,0,0,0,0,0.0,0.0,0.0
aelf,0,0,0,0,0.0,0.0,0.0
eth birds,0,0,0,0,0.0,0.0,0.0
webloc,2,0,9,11,18.181818181818183,0.0,81.81818181818183
superbloom,0,0,0,0,0.0,0.0,0.0
rise,64,23,65,152,42.10526315789473,15.131578947368421,42.76315789473684
bitsrent,0,0,0,0,0.0,0.0,0.0
cryptocoin insurance,0,0,0,0,0.0,0.0,0.0
job.com,0,0,0,0,0.0,0.0,0.0
bionic,0,0,0,0,0.0,0.0,0.0
renaissance engineering,0,0,0,0,0.0,0.0,0.0
cubiex,0,0,0,0,0.0,0.0,0.0
qredit,0,0,2,2,0.0,0.0,100.0
digitalbits,0,0,0,0,0.0,0.0,0.0
iuno,0,0,1,1,0.0,0.0,100.0
emusic,0,0,0,0,0.0,0.0,0.0
restart energy,0,0,0,0,0.0,0.0,0.0
infinitus,2,1,2,5,40.0,20.0,40.0
lampix,0,0,0,0,0.0,0.0,0.0
magnetics,3,6,5,14,21.428571428571427,42.857142857142854,35.714285714285715
aora,0,0,0,0,0.0,0.0,0.0
sportsfix,0,0,1,1,0.0,0.0,100.0
qlear protocol,0,0,1,1,0.0,0.0,100.0
morlabs,0,0,0,0,0.0,0.0,0.0
wooshcoin,0,0,0,0,0.0,0.0,0.0
coinbates,0,0,0,0,0.0,0.0,0.0
ono,5,2,3,10,50.0,20.0,30.0
triphop,2,1,1,4,50.0,25.0,25.0
neironix,0,0,0,0,0.0,0.0,0.0
powerchain,3,1,5,9,33.33333333333333,11.11111111111111,55.55555555555556
xenia,1,0,1,2,50.0,0.0,50.0
your data safe,0,0,0,0,0.0,0.0,0.0
pigzbe,0,0,0,0,0.0,0.0,0.0
balehu protocol,4,0,0,4,100.0,0.0,0.0
storiqa,0,0,0,0,0.0,0.0,0.0
centaure,0,0,0,0,0.0,0.0,0.0
loopring,14,6,26,46,30.434782608695656,13.043478260869565,56.52173913043478
ai crypto,0,0,0,0,0.0,0.0,0.0
spin protocol,0,0,1,1,0.0,0.0,100.0
social media pay,0,0,0,0,0.0,0.0,0.0
abbc foundation,0,0,0,0,0.0,0.0,0.0
redi,0,0,0,0,0.0,0.0,0.0
logisticsx,0,0,1,1,0.0,0.0,100.0
fastrader,0,0,0,0,0.0,0.0,0.0
tokenbacon,0,0,2,2,0.0,0.0,100.0
suapp,0,0,0,0,0.0,0.0,0.0
districts,2,3,2,7,28.57142857142857,42.857142857142854,28.57142857142857
ecta,0,0,0,0,0.0,0.0,0.0
silent notary,0,0,0,0,0.0,0.0,0.0
centive,0,0,0,0,0.0,0.0,0.0
pingpaid,0,0,0,0,0.0,0.0,0.0
becent,0,0,0,0,0.0,0.0,0.0
xtribe,1,0,1,2,50.0,0.0,50.0
inlock,0,0,0,0,0.0,0.0,0.0
krypti,0,0,0,0,0.0,0.0,0.0
asobi coin,2,0,0,2,100.0,0.0,0.0
borneo,0,0,0,0,0.0,0.0,0.0
nerves foundation,0,0,0,0,0.0,0.0,0.0
tatau,0,0,0,0,0.0,0.0,0.0
aenco,0,0,0,0,0.0,0.0,0.0
cybervein,1,0,0,1,100.0,0.0,0.0
karatcoin,5,0,1,6,83.33333333333334,0.0,16.666666666666664
artpro,0,0,0,0,0.0,0.0,0.0
penchant,0,0,1,1,0.0,0.0,100.0
parkade,0,0,1,1,0.0,0.0,100.0
nonzero,1,1,2,4,25.0,25.0,50.0
cardonio,0,0,0,0,0.0,0.0,0.0
sansox,0,0,0,0,0.0,0.0,0.0
swachhcoin,0,0,0,0,0.0,0.0,0.0
shopin,0,0,0,0,0.0,0.0,0.0
blockkonnect,0,0,0,0,0.0,0.0,0.0
dclinic,5,0,0,5,100.0,0.0,0.0
x-cash,13,4,6,23,56.52173913043478,17.391304347826086,26.08695652173913
vibeo,0,0,0,0,0.0,0.0,0.0
masternode invest,0,0,0,0,0.0,0.0,0.0
topex,2,0,0,2,100.0,0.0,0.0
berminal,0,0,0,0,0.0,0.0,0.0
expanse,1,2,0,3,33.33333333333333,66.66666666666666,0.0
osmium investment coin,0,0,0,0,0.0,0.0,0.0
aura,6,7,4,17,35.294117647058826,41.17647058823529,23.52941176470588
wmpro,1,0,0,1,100.0,0.0,0.0
securix,0,0,0,0,0.0,0.0,0.0
udap,0,0,0,0,0.0,0.0,0.0
olife,0,0,0,0,0.0,0.0,0.0
curaizon,2,0,0,2,100.0,0.0,0.0
odin,7,7,4,18,38.88888888888889,38.88888888888889,22.22222222222222
contents protocol,1,0,0,1,100.0,0.0,0.0
beverage cash,0,0,0,0,0.0,0.0,0.0
xmax,0,0,0,0,0.0,0.0,0.0
scienceroot,1,0,0,1,100.0,0.0,0.0
spheroid universe,4,0,0,4,100.0,0.0,0.0
x-block,14,0,2,16,87.5,0.0,12.5
buying,181,135,446,762,23.753280839895012,17.716535433070867,58.53018372703412
one game,4,1,10,15,26.666666666666668,6.666666666666667,66.66666666666666
wom token,1,0,1,2,50.0,0.0,50.0
caspian,0,0,0,0,0.0,0.0,0.0
ilink2music,1,0,0,1,100.0,0.0,0.0
natmin pure escrow,3,0,0,3,100.0,0.0,0.0
kineticex,0,0,0,0,0.0,0.0,0.0
zwoop,0,0,0,0,0.0,0.0,0.0
indx capital,0,0,0,0,0.0,0.0,0.0
payx,0,0,0,0,0.0,0.0,0.0
skynet,2,1,1,4,50.0,25.0,25.0
loveblock,0,0,0,0,0.0,0.0,0.0
ttc protocol,0,0,0,0,0.0,0.0,0.0
bithereum,0,0,0,0,0.0,0.0,0.0
moac,0,0,0,0,0.0,0.0,0.0
bitfam,0,0,0,0,0.0,0.0,0.0
republia,0,0,0,0,0.0,0.0,0.0
funkeypay,0,0,0,0,0.0,0.0,0.0
papusha,0,0,0,0,0.0,0.0,0.0
itrue,0,0,0,0,0.0,0.0,0.0
beam,5,5,6,16,31.25,31.25,37.5
kimex,2,1,1,4,50.0,25.0,25.0
twogap,0,0,0,0,0.0,0.0,0.0
lattice80,0,0,0,0,0.0,0.0,0.0
florafic,0,0,0,0,0.0,0.0,0.0
bitmart,1,0,0,1,100.0,0.0,0.0
efforce,0,0,0,0,0.0,0.0,0.0
spiking,0,5,4,9,0.0,55.55555555555556,44.44444444444444
bidooh,2,2,5,9,22.22222222222222,22.22222222222222,55.55555555555556
imusify,1,0,1,2,50.0,0.0,50.0
icovo,0,0,0,0,0.0,0.0,0.0
cloudbric,6,0,5,11,54.54545454545454,0.0,45.45454545454545
tachain,0,0,0,0,0.0,0.0,0.0
workchain,0,0,0,0,0.0,0.0,0.0
brokernekonetwork,0,0,0,0,0.0,0.0,0.0
subaj,0,2,2,4,0.0,50.0,50.0
scanetchain,0,0,0,0,0.0,0.0,0.0
payperblock,1,0,0,1,100.0,0.0,0.0
greenlink,1,2,4,7,14.285714285714285,28.57142857142857,57.14285714285714
55 exchange,0,0,0,0,0.0,0.0,0.0
finnoq,0,0,1,1,0.0,0.0,100.0
platio,0,0,0,0,0.0,0.0,0.0
dx.exchange,2,0,0,2,100.0,0.0,0.0
bcoin,0,0,0,0,0.0,0.0,0.0
skrumble network,1,0,1,2,50.0,0.0,50.0
etherinc,0,0,0,0,0.0,0.0,0.0
myos,0,0,0,0,0.0,0.0,0.0
eurekapro,0,0,0,0,0.0,0.0,0.0
avatara,1,0,1,2,50.0,0.0,50.0
odyssey,3,2,2,7,42.857142857142854,28.57142857142857,28.57142857142857
rate3,0,0,0,0,0.0,0.0,0.0
bouncy coin,0,0,0,0,0.0,0.0,0.0
agentmile,0,0,0,0,0.0,0.0,0.0
hirefreehands,6,0,3,9,66.66666666666666,0.0,33.33333333333333
denarii cash,0,0,0,0,0.0,0.0,0.0
webdollar,0,0,0,0,0.0,0.0,0.0
webuy,5,2,3,10,50.0,20.0,30.0
meca coin,0,1,2,3,0.0,33.33333333333333,66.66666666666666
abele group,0,0,0,0,0.0,0.0,0.0
agate,0,0,0,0,0.0,0.0,0.0
kronos token,0,0,0,0,0.0,0.0,0.0
wandx,5,5,5,15,33.33333333333333,33.33333333333333,33.33333333333333
envoy,0,0,0,0,0.0,0.0,0.0
iride,1,0,0,1,100.0,0.0,0.0
synthetics ai,6,0,0,6,100.0,0.0,0.0
symphony,0,0,0,0,0.0,0.0,0.0
margin,17,22,58,97,17.525773195876287,22.68041237113402,59.79381443298969
gsc aviation,0,0,0,0,0.0,0.0,0.0
share internet data,0,0,0,0,0.0,0.0,0.0
metahash,0,0,0,0,0.0,0.0,0.0
hyperquant,0,0,0,0,0.0,0.0,0.0
kheper,0,0,0,0,0.0,0.0,0.0
opporty,0,0,0,0,0.0,0.0,0.0
blackbox foundation,0,0,0,0,0.0,0.0,0.0
medchain,0,2,0,2,0.0,100.0,0.0
viddo,0,0,0,0,0.0,0.0,0.0
greenhashes,0,0,0,0,0.0,0.0,0.0
pearl pay,0,0,0,0,0.0,0.0,0.0
high performance blockchain,0,0,0,0,0.0,0.0,0.0
conference coin,0,0,0,0,0.0,0.0,0.0
yondocoin,0,0,0,0,0.0,0.0,0.0
kvantor,0,2,0,2,0.0,100.0,0.0
jupiter chain,0,0,0,0,0.0,0.0,0.0
zerostate,0,0,0,0,0.0,0.0,0.0
mapcoin,6,1,0,7,85.71428571428571,14.285714285714285,0.0
eyeglob.net,5,0,0,5,100.0,0.0,0.0
crypviser,1,0,1,2,50.0,0.0,50.0
marachain,0,0,0,0,0.0,0.0,0.0
nextpakk,3,2,0,5,60.0,40.0,0.0
distributed blocks,1,0,0,1,100.0,0.0,0.0
fieldcoin,0,0,0,0,0.0,0.0,0.0
veiag,5,0,2,7,71.42857142857143,0.0,28.57142857142857
locktrip,0,0,0,0,0.0,0.0,0.0
zinc,6,1,4,11,54.54545454545454,9.090909090909092,36.36363636363637
spl.yt,4,0,1,5,80.0,0.0,20.0
silkchain,0,0,2,2,0.0,0.0,100.0
unitalent,0,0,0,0,0.0,0.0,0.0
careerchain,0,0,0,0,0.0,0.0,0.0
craftr,0,0,0,0,0.0,0.0,0.0
thingschain,0,0,0,0,0.0,0.0,0.0
hashgard,0,0,0,0,0.0,0.0,0.0
daviescoin,0,0,0,0,0.0,0.0,0.0
contractium,0,0,0,0,0.0,0.0,0.0
mobu,1,0,0,1,100.0,0.0,0.0
philanthor,0,0,0,0,0.0,0.0,0.0
medipedia,0,0,0,0,0.0,0.0,0.0
tlpac,15,0,0,15,100.0,0.0,0.0
sports ledger,0,0,0,0,0.0,0.0,0.0
real estate doc,0,0,0,0,0.0,0.0,0.0
careonchain,0,0,0,0,0.0,0.0,0.0
project h,0,0,0,0,0.0,0.0,0.0
dream & indorse,0,0,0,0,0.0,0.0,0.0
buratinobs,0,0,0,0,0.0,0.0,0.0
openbrix,0,0,0,0,0.0,0.0,0.0
vu token,0,0,0,0,0.0,0.0,0.0
boliecoin,0,0,0,0,0.0,0.0,0.0
campuscoin,0,0,0,0,0.0,0.0,0.0
ripaex,1,1,0,2,50.0,50.0,0.0
blockvest,0,0,0,0,0.0,0.0,0.0
neoplace,0,0,0,0,0.0,0.0,0.0
intro,14,15,13,42,33.33333333333333,35.714285714285715,30.952380952380953
gstar ecosystem,1,0,1,2,50.0,0.0,50.0
everipedia,0,0,1,1,0.0,0.0,100.0
zerobank,2,0,0,2,100.0,0.0,0.0
vidy,0,0,0,0,0.0,0.0,0.0
attrace,0,0,0,0,0.0,0.0,0.0
svper,0,3,1,4,0.0,75.0,25.0
rockercoin,0,0,0,0,0.0,0.0,0.0
rays network,0,0,0,0,0.0,0.0,0.0
tokenize,0,0,3,3,0.0,0.0,100.0
dream real,0,0,0,0,0.0,0.0,0.0
asian develop coin,0,0,0,0,0.0,0.0,0.0
airstayz,0,0,1,1,0.0,0.0,100.0
yinc,0,0,0,0,0.0,0.0,0.0
bloxia,0,0,0,0,0.0,0.0,0.0
color,106,71,62,239,44.35146443514644,29.707112970711297,25.94142259414226
watermelonblock,0,0,0,0,0.0,0.0,0.0
hurtle coin,2,0,0,2,100.0,0.0,0.0
bigbang,5,2,7,14,35.714285714285715,14.285714285714285,50.0
starflow,0,0,0,0,0.0,0.0,0.0
mytc,0,0,0,0,0.0,0.0,0.0
aniko,4,4,1,9,44.44444444444444,44.44444444444444,11.11111111111111
w green pay,1,0,1,2,50.0,0.0,50.0
guarium,1,0,0,1,100.0,0.0,0.0
prime shipping foundation,0,0,0,0,0.0,0.0,0.0
propy,2,1,5,8,25.0,12.5,62.5
easy trading platform,0,0,0,0,0.0,0.0,0.0
dnet,0,0,0,0,0.0,0.0,0.0
meritt protocol,0,0,0,0,0.0,0.0,0.0
star bit,0,0,0,0,0.0,0.0,0.0
multra,2,0,1,3,66.66666666666666,0.0,33.33333333333333
expercoin,0,0,0,0,0.0,0.0,0.0
kava,3,4,3,10,30.0,40.0,30.0
bytemine,1,0,0,1,100.0,0.0,0.0
unico,0,3,5,8,0.0,37.5,62.5
diro,0,0,0,0,0.0,0.0,0.0
gratzio,0,0,0,0,0.0,0.0,0.0
bixtrim,1,0,0,1,100.0,0.0,0.0
inmediate,0,0,0,0,0.0,0.0,0.0
jsecoin,0,0,0,0,0.0,0.0,0.0
medilot,0,0,0,0,0.0,0.0,0.0
pchain,0,0,0,0,0.0,0.0,0.0
helix orange,0,0,1,1,0.0,0.0,100.0
shipit,0,0,0,0,0.0,0.0,0.0
miracle tele,2,0,0,2,100.0,0.0,0.0
runs,51,57,87,195,26.153846153846157,29.230769230769234,44.61538461538462
ignite,7,3,2,12,58.333333333333336,25.0,16.666666666666664
elyqd,0,0,0,0,0.0,0.0,0.0
bailsman,0,0,0,0,0.0,0.0,0.0
lambda,2,1,1,4,50.0,25.0,25.0
rubius,1,3,4,8,12.5,37.5,50.0
svandis,3,0,0,3,100.0,0.0,0.0
allsporter,0,0,0,0,0.0,0.0,0.0
playrs,0,0,0,0,0.0,0.0,0.0
coinanalyst,0,0,0,0,0.0,0.0,0.0
spokkz,8,2,2,12,66.66666666666666,16.666666666666664,16.666666666666664
zantepay,0,0,0,0,0.0,0.0,0.0
cure cosplay,0,0,0,0,0.0,0.0,0.0
wab network,0,0,0,0,0.0,0.0,0.0
liquid8,1,2,1,4,25.0,50.0,25.0
fanship,0,0,0,0,0.0,0.0,0.0
inmusik,2,2,0,4,50.0,50.0,0.0
crowdtoken,0,0,0,0,0.0,0.0,0.0
osa,1,0,4,5,20.0,0.0,80.0
moolyacoin,1,0,2,3,33.33333333333333,0.0,66.66666666666666
hyperbridge,0,0,0,0,0.0,0.0,0.0
tombcare,0,0,0,0,0.0,0.0,0.0
tuurnt,0,0,0,0,0.0,0.0,0.0
usechain,0,0,0,0,0.0,0.0,0.0
storeplex,0,0,0,0,0.0,0.0,0.0
parcelx,2,0,0,2,100.0,0.0,0.0
apres,9,10,3,22,40.909090909090914,45.45454545454545,13.636363636363635
blockhive,0,0,0,0,0.0,0.0,0.0
creatanium,0,0,0,0,0.0,0.0,0.0
traderiser,0,0,0,0,0.0,0.0,0.0
redcab,0,0,0,0,0.0,0.0,0.0
monopoly,10,6,60,76,13.157894736842104,7.894736842105263,78.94736842105263
sharevest,0,0,0,0,0.0,0.0,0.0
explorio,0,0,0,0,0.0,0.0,0.0
epiphany,2,0,0,2,100.0,0.0,0.0
bumo,0,0,0,0,0.0,0.0,0.0
barrel,4,5,8,17,23.52941176470588,29.411764705882355,47.05882352941176
cryptomillionslotto,0,0,0,0,0.0,0.0,0.0
immvrse,1,0,1,2,50.0,0.0,50.0
atidium,0,0,0,0,0.0,0.0,0.0
dto,0,0,0,0,0.0,0.0,0.0
provoco,0,0,3,3,0.0,0.0,100.0
traxion,0,0,0,0,0.0,0.0,0.0
bitesprit,0,0,0,0,0.0,0.0,0.0
heroic.com,0,0,0,0,0.0,0.0,0.0
dench music,0,0,0,0,0.0,0.0,0.0
versara trade,0,0,0,0,0.0,0.0,0.0
miboodle,0,0,0,0,0.0,0.0,0.0
hellogold,0,0,0,0,0.0,0.0,0.0
odmcoin,0,0,0,0,0.0,0.0,0.0
waves,11,5,16,32,34.375,15.625,50.0
mevu,0,0,0,0,0.0,0.0,0.0
casper api,0,0,0,0,0.0,0.0,0.0
lition,0,0,0,0,0.0,0.0,0.0
scidex,6,0,1,7,85.71428571428571,0.0,14.285714285714285
betform,0,0,0,0,0.0,0.0,0.0
yanu,3,7,1,11,27.27272727272727,63.63636363636363,9.090909090909092
little phil,4,0,0,4,100.0,0.0,0.0
monoreto,1,0,0,1,100.0,0.0,0.0
grapevine world,0,0,0,0,0.0,0.0,0.0
blockonomics,0,0,0,0,0.0,0.0,0.0
nauticus,0,0,0,0,0.0,0.0,0.0
further network,0,0,0,0,0.0,0.0,0.0
breezecoin,2,0,0,2,100.0,0.0,0.0
racoin,0,0,0,0,0.0,0.0,0.0
tresaro,0,0,0,0,0.0,0.0,0.0
wemark,0,0,0,0,0.0,0.0,0.0
setteo,0,0,2,2,0.0,0.0,100.0
ern,0,0,0,0,0.0,0.0,0.0
terawatt,0,0,0,0,0.0,0.0,0.0
cryptovationx,0,0,0,0,0.0,0.0,0.0
feedchain,5,0,0,5,100.0,0.0,0.0
basis neuro,0,0,0,0,0.0,0.0,0.0
staramba,2,1,0,3,66.66666666666666,33.33333333333333,0.0
re:factor,8,0,0,8,100.0,0.0,0.0
greenx,1,1,2,4,25.0,25.0,50.0
ftw,4,1,4,9,44.44444444444444,11.11111111111111,44.44444444444444
atlantis blue,0,0,0,0,0.0,0.0,0.0
parkres,0,0,0,0,0.0,0.0,0.0
lendsbay,0,0,0,0,0.0,0.0,0.0
0xcert,0,0,0,0,0.0,0.0,0.0
humanscape,0,0,0,0,0.0,0.0,0.0
crowdif,0,0,0,0,0.0,0.0,0.0
videocoin,7,0,0,7,100.0,0.0,0.0
nebula,11,4,5,20,55.00000000000001,20.0,25.0
neonameservice,0,1,0,1,0.0,100.0,0.0
sparkster,0,0,0,0,0.0,0.0,0.0
buddy,76,13,61,150,50.66666666666667,8.666666666666668,40.666666666666664
crypstock,0,0,0,0,0.0,0.0,0.0
luvdub,3,1,2,6,50.0,16.666666666666664,33.33333333333333
aworker,0,0,0,0,0.0,0.0,0.0
qlc chain,0,0,0,0,0.0,0.0,0.0
sponsy,0,0,0,0,0.0,0.0,0.0
menlo one,0,0,0,0,0.0,0.0,0.0
wesend,0,0,0,0,0.0,0.0,0.0
inscoin,19,0,3,22,86.36363636363636,0.0,13.636363636363635
extrade,0,0,0,0,0.0,0.0,0.0
muxe,0,0,0,0,0.0,0.0,0.0
lina,1,0,0,1,100.0,0.0,0.0
zoidcoin,1,0,0,1,100.0,0.0,0.0
origin sport,0,0,0,0,0.0,0.0,0.0
no bs crypto,0,0,4,4,0.0,0.0,100.0
cosmecoin,0,0,1,1,0.0,0.0,100.0
railz,0,0,0,0,0.0,0.0,0.0
contentbox,14,0,3,17,82.35294117647058,0.0,17.647058823529413
rloop,0,0,0,0,0.0,0.0,0.0
bitney,1,0,1,2,50.0,0.0,50.0
apis,7,9,4,20,35.0,45.0,20.0
xmed chain,0,0,0,0,0.0,0.0,0.0
indicoin,0,0,0,0,0.0,0.0,0.0
nobar,0,0,0,0,0.0,0.0,0.0
coinself,0,1,0,1,0.0,100.0,0.0
makeafolio,0,0,0,0,0.0,0.0,0.0
iris.ai,0,1,0,1,0.0,100.0,0.0
deedcoin,0,0,0,0,0.0,0.0,0.0
dav,0,0,0,0,0.0,0.0,0.0
find.exchange,4,0,4,8,50.0,0.0,50.0
ingot coin,2,0,0,2,100.0,0.0,0.0
profede,0,0,0,0,0.0,0.0,0.0
box 2 table,0,0,0,0,0.0,0.0,0.0
globecas,0,0,0,0,0.0,0.0,0.0
goeureka,0,0,0,0,0.0,0.0,0.0
xeeda,0,0,0,0,0.0,0.0,0.0
recordskeeper,0,0,0,0,0.0,0.0,0.0
datavlt,2,0,0,2,100.0,0.0,0.0
jibbit,2,0,1,3,66.66666666666666,0.0,33.33333333333333
loyakk,0,0,0,0,0.0,0.0,0.0
avinoc,4,2,7,13,30.76923076923077,15.384615384615385,53.84615384615385
tokenunion,0,0,0,0,0.0,0.0,0.0
root blockchain,0,0,0,0,0.0,0.0,0.0
ormeus coin,0,0,0,0,0.0,0.0,0.0
cryptoriya,0,0,0,0,0.0,0.0,0.0
mjolnir guard,0,0,0,0,0.0,0.0,0.0
daox,0,0,0,0,0.0,0.0,0.0
pavocoin,1,1,0,2,50.0,50.0,0.0
brainmab,0,0,0,0,0.0,0.0,0.0
viewo,0,0,0,0,0.0,0.0,0.0
fanfare,1,1,0,2,50.0,50.0,0.0
crystals,11,12,22,45,24.444444444444443,26.666666666666668,48.888888888888886
xgenomics,0,0,0,0,0.0,0.0,0.0
gese,0,0,0,0,0.0,0.0,0.0
askfm 2.0,0,0,0,0,0.0,0.0,0.0
b2bx,0,0,0,0,0.0,0.0,0.0
lamoneda,0,0,0,0,0.0,0.0,0.0
accounting blockchain,0,0,0,0,0.0,0.0,0.0
energi token,0,0,0,0,0.0,0.0,0.0
nebeus,0,0,0,0,0.0,0.0,0.0
iregmed,0,0,0,0,0.0,0.0,0.0
paygine,0,0,0,0,0.0,0.0,0.0
ivy,2,0,4,6,33.33333333333333,0.0,66.66666666666666
binex.trade,8,2,1,11,72.72727272727273,18.181818181818183,9.090909090909092
selfie go,0,0,0,0,0.0,0.0,0.0
clash & go,3,0,0,3,100.0,0.0,0.0
miner edge,5,0,0,5,100.0,0.0,0.0
keplertek,0,0,0,0,0.0,0.0,0.0
ink,6,1,12,19,31.57894736842105,5.263157894736842,63.1578947368421
kimera,8,6,6,20,40.0,30.0,30.0
prime ball,1,0,0,1,100.0,0.0,0.0
aitheon,0,0,0,0,0.0,0.0,0.0
tatatu,0,0,0,0,0.0,0.0,0.0
supporter,5,2,15,22,22.727272727272727,9.090909090909092,68.18181818181817
neodium network,0,0,0,0,0.0,0.0,0.0
acudeen,0,0,0,0,0.0,0.0,0.0
easyloot,0,0,0,0,0.0,0.0,0.0
vimana,2,2,1,5,40.0,40.0,20.0
denet,0,0,0,0,0.0,0.0,0.0
goldma,0,0,0,0,0.0,0.0,0.0
ommer,0,0,0,0,0.0,0.0,0.0
viva network,0,0,0,0,0.0,0.0,0.0
leadrex,1,2,2,5,20.0,40.0,40.0
po8,0,0,0,0,0.0,0.0,0.0
smartmesh,0,0,0,0,0.0,0.0,0.0
atn,0,0,0,0,0.0,0.0,0.0
luna,44,44,88,176,25.0,25.0,50.0
fenix,1,0,0,1,100.0,0.0,0.0
successlife,0,0,0,0,0.0,0.0,0.0
planport,0,0,0,0,0.0,0.0,0.0
datecoin,0,0,0,0,0.0,0.0,0.0
archicoin,0,0,0,0,0.0,0.0,0.0
cryptohit,0,0,0,0,0.0,0.0,0.0
jiojiome,0,0,0,0,0.0,0.0,0.0
genexi,0,0,0,0,0.0,0.0,0.0
mcoin,0,0,0,0,0.0,0.0,0.0
conda,0,0,0,0,0.0,0.0,0.0
koumei,0,3,0,3,0.0,100.0,0.0
hodlit network,0,0,0,0,0.0,0.0,0.0
skyfchain,1,0,0,1,100.0,0.0,0.0
coinyspace,0,0,0,0,0.0,0.0,0.0
fructus,0,0,0,0,0.0,0.0,0.0
horizon,8,4,11,23,34.78260869565217,17.391304347826086,47.82608695652174
kanadecoin,0,0,0,0,0.0,0.0,0.0
xriba,0,0,0,0,0.0,0.0,0.0
towerbee,0,0,0,0,0.0,0.0,0.0
mst,0,0,0,0,0.0,0.0,0.0
etherc,0,0,0,0,0.0,0.0,0.0
elepig,0,0,0,0,0.0,0.0,0.0
dino,1,0,5,6,16.666666666666664,0.0,83.33333333333334
laborcrypto,0,0,0,0,0.0,0.0,0.0
md tokens,0,0,0,0,0.0,0.0,0.0
bitimage,0,0,0,0,0.0,0.0,0.0
byteball,0,0,0,0,0.0,0.0,0.0
grabameal,0,0,1,1,0.0,0.0,100.0
gledos,1,0,0,1,100.0,0.0,0.0
carlive chain,0,0,0,0,0.0,0.0,0.0
wono,0,0,0,0,0.0,0.0,0.0
selfsell,0,0,0,0,0.0,0.0,0.0
acute coin,0,0,2,2,0.0,0.0,100.0
cryptoflix,0,0,2,2,0.0,0.0,100.0
hubtoken,0,0,0,0,0.0,0.0,0.0
ico pass,0,0,0,0,0.0,0.0,0.0
amicorum live,0,0,0,0,0.0,0.0,0.0
global reit,0,1,0,1,0.0,100.0,0.0
wizebit,0,0,0,0,0.0,0.0,0.0
zichain,1,0,2,3,33.33333333333333,0.0,66.66666666666666
tradingene,1,0,0,1,100.0,0.0,0.0
okeydokey,0,0,0,0,0.0,0.0,0.0
birdchain,5,0,2,7,71.42857142857143,0.0,28.57142857142857
freelancercoin,0,0,0,0,0.0,0.0,0.0
blue whale,3,4,6,13,23.076923076923077,30.76923076923077,46.15384615384615
goldmint,0,0,0,0,0.0,0.0,0.0
evolutionos,4,0,1,5,80.0,0.0,20.0
linfinity,4,0,0,4,100.0,0.0,0.0
cortex,0,4,0,4,0.0,100.0,0.0
crowd for angels,0,0,2,2,0.0,0.0,100.0
iconiq lab,5,0,1,6,83.33333333333334,0.0,16.666666666666664
arousal,1,1,1,3,33.33333333333333,33.33333333333333,33.33333333333333
cgcx,2,0,0,2,100.0,0.0,0.0
wulet,0,0,0,0,0.0,0.0,0.0
elysian,0,0,0,0,0.0,0.0,0.0
coinet,0,0,0,0,0.0,0.0,0.0
lancer network,0,0,0,0,0.0,0.0,0.0
safe haven,4,1,1,6,66.66666666666666,16.666666666666664,16.666666666666664
araw token,1,1,2,4,25.0,25.0,50.0
directhome,0,0,0,0,0.0,0.0,0.0
buzcoin,0,0,1,1,0.0,0.0,100.0
dicegame,0,0,0,0,0.0,0.0,0.0
beepbeep nation,1,0,0,1,100.0,0.0,0.0
abcc exchange,0,0,0,0,0.0,0.0,0.0
deconet,0,0,0,0,0.0,0.0,0.0
datablockchain,0,0,0,0,0.0,0.0,0.0
carblock,0,0,0,0,0.0,0.0,0.0
bulleon,0,0,0,0,0.0,0.0,0.0
coincrowd,0,0,0,0,0.0,0.0,0.0
rankingball,3,0,0,3,100.0,0.0,0.0
bubbletone,3,0,1,4,75.0,0.0,25.0
mpcx,0,0,0,0,0.0,0.0,0.0
blockstorage,0,0,0,0,0.0,0.0,0.0
xceltoken plus,0,0,0,0,0.0,0.0,0.0
xchng,0,0,0,0,0.0,0.0,0.0
trustlogics,0,0,0,0,0.0,0.0,0.0
bitrent,0,0,0,0,0.0,0.0,0.0
free market token,1,0,1,2,50.0,0.0,50.0
starchain,0,0,4,4,0.0,0.0,100.0
abitchain,0,0,0,0,0.0,0.0,0.0
check-car,0,0,0,0,0.0,0.0,0.0
ai gaming,0,0,0,0,0.0,0.0,0.0
abacasxchange,1,0,0,1,100.0,0.0,0.0
ether joy,0,0,0,0,0.0,0.0,0.0
blockport,0,0,0,0,0.0,0.0,0.0
concertvr,0,0,0,0,0.0,0.0,0.0
bitminutes,0,0,0,0,0.0,0.0,0.0
bfex,0,0,1,1,0.0,0.0,100.0
hangry animals,2,0,0,2,100.0,0.0,0.0
argent,5,3,3,11,45.45454545454545,27.27272727272727,27.27272727272727
limocoinswap,0,0,0,0,0.0,0.0,0.0
socean,0,0,0,0,0.0,0.0,0.0
cfun,0,0,0,0,0.0,0.0,0.0
coin governance system,0,0,0,0,0.0,0.0,0.0
cryde,2,1,2,5,40.0,20.0,40.0
belotto,2,0,0,2,100.0,0.0,0.0
terra virtua,0,0,0,0,0.0,0.0,0.0
olympus labs,1,1,4,6,16.666666666666664,16.666666666666664,66.66666666666666
proton,5,2,7,14,35.714285714285715,14.285714285714285,50.0
touch. social network,0,0,0,0,0.0,0.0,0.0
zeex,0,0,0,0,0.0,0.0,0.0
autobay,0,0,0,0,0.0,0.0,0.0
cargochain,0,0,0,0,0.0,0.0,0.0
4new,0,0,0,0,0.0,0.0,0.0
moveco,0,1,0,1,0.0,100.0,0.0
gladage,0,0,0,0,0.0,0.0,0.0
indorse,0,0,0,0,0.0,0.0,0.0
unboxed,0,0,0,0,0.0,0.0,0.0
metamorph,0,0,0,0,0.0,0.0,0.0
delicia,0,1,4,5,0.0,20.0,80.0
0chain,0,0,0,0,0.0,0.0,0.0
esports chain,0,0,0,0,0.0,0.0,0.0
smart trip platform,0,0,0,0,0.0,0.0,0.0
trustnote,0,0,0,0,0.0,0.0,0.0
parsec frontiers,0,0,0,0,0.0,0.0,0.0
mine coin,0,0,0,0,0.0,0.0,0.0
bitrust,0,0,0,0,0.0,0.0,0.0
deeptoken,0,0,0,0,0.0,0.0,0.0
workcoin,0,0,2,2,0.0,0.0,100.0
mcfly,0,0,0,0,0.0,0.0,0.0
coinmetro,0,0,0,0,0.0,0.0,0.0
kryptono exchange,0,0,0,0,0.0,0.0,0.0
dapp builder,0,0,0,0,0.0,0.0,0.0
prevue,2,1,5,8,25.0,12.5,62.5
ethichub twitter,0,0,0,0,0.0,0.0,0.0
urbit,2,0,0,2,100.0,0.0,0.0
boosto,1,0,0,1,100.0,0.0,0.0
assettoken,0,1,1,2,0.0,50.0,50.0
anything app,0,0,0,0,0.0,0.0,0.0
pointium,2,0,0,2,100.0,0.0,0.0
biok,0,0,0,0,0.0,0.0,0.0
bitmillex,0,0,0,0,0.0,0.0,0.0
bidipass,0,0,0,0,0.0,0.0,0.0
sentinel protocol,3,1,3,7,42.857142857142854,14.285714285714285,42.857142857142854
moneytoken,0,0,0,0,0.0,0.0,0.0
bitsum,1,0,0,1,100.0,0.0,0.0
endorsit,1,1,0,2,50.0,50.0,0.0
sdchain,1,1,0,2,50.0,50.0,0.0
mingo,3,10,18,31,9.67741935483871,32.25806451612903,58.06451612903226
libertylance,0,0,0,0,0.0,0.0,0.0
block broker,0,0,0,0,0.0,0.0,0.0
hyperion,0,0,0,0,0.0,0.0,0.0
golden currency,0,0,0,0,0.0,0.0,0.0
digipulse,0,0,0,0,0.0,0.0,0.0
exchain,3,1,1,5,60.0,20.0,20.0
spindle,7,10,12,29,24.137931034482758,34.48275862068966,41.37931034482759
seda,0,0,0,0,0.0,0.0,0.0
vivalid,1,0,0,1,100.0,0.0,0.0
mbys,0,0,0,0,0.0,0.0,0.0
xenchain,0,0,0,0,0.0,0.0,0.0
kakushin,0,0,0,0,0.0,0.0,0.0
evo,8,8,7,23,34.78260869565217,34.78260869565217,30.434782608695656
strykz,0,0,0,0,0.0,0.0,0.0
kelta,0,0,0,0,0.0,0.0,0.0
rawg,6,3,2,11,54.54545454545454,27.27272727272727,18.181818181818183
aict,0,0,0,0,0.0,0.0,0.0
meshbox,5,0,0,5,100.0,0.0,0.0
eosdac,0,1,1,2,0.0,50.0,50.0
eatmecoin,0,0,0,0,0.0,0.0,0.0
superset,8,8,3,19,42.10526315789473,42.10526315789473,15.789473684210526
coinpaws,2,0,1,3,66.66666666666666,0.0,33.33333333333333
trident group,0,0,0,0,0.0,0.0,0.0
prontapay,0,0,0,0,0.0,0.0,0.0
akaiito,0,0,0,0,0.0,0.0,0.0
smarto,0,0,0,0,0.0,0.0,0.0
entry,42,49,66,157,26.751592356687897,31.210191082802545,42.038216560509554
digitize,6,1,1,8,75.0,12.5,12.5
vinchain,0,0,0,0,0.0,0.0,0.0
bit.game,1,4,2,7,14.285714285714285,57.14285714285714,28.57142857142857
pecunio,0,0,0,0,0.0,0.0,0.0
labstart,0,0,0,0,0.0,0.0,0.0
vexanium,0,0,0,0,0.0,0.0,0.0
qryptos exchange,0,0,0,0,0.0,0.0,0.0
thekey,2,2,1,5,40.0,40.0,20.0
echolink,9,3,7,19,47.368421052631575,15.789473684210526,36.84210526315789
ethichub,0,0,0,0,0.0,0.0,0.0
marginless,0,0,0,0,0.0,0.0,0.0
able,430,382,665,1477,29.11306702775897,25.863236289776577,45.023696682464454
cosmochain,3,2,4,9,33.33333333333333,22.22222222222222,44.44444444444444
chronobank,0,0,0,0,0.0,0.0,0.0
bitrewards,0,0,0,0,0.0,0.0,0.0
vanig,0,0,0,0,0.0,0.0,0.0
london football exchange,0,0,0,0,0.0,0.0,0.0
lemochain,0,0,0,0,0.0,0.0,0.0
surrus,0,0,0,0,0.0,0.0,0.0
cprop,3,1,0,4,75.0,25.0,0.0
bundle,3,8,10,21,14.285714285714285,38.095238095238095,47.61904761904761
3des,3,7,9,19,15.789473684210526,36.84210526315789,47.368421052631575
contract vault,0,0,0,0,0.0,0.0,0.0
modex,0,0,0,0,0.0,0.0,0.0
modorr,2,0,1,3,66.66666666666666,0.0,33.33333333333333
bitfence,0,0,0,0,0.0,0.0,0.0
maximine,0,0,0,0,0.0,0.0,0.0
biotron,1,1,2,4,25.0,25.0,50.0
berith,0,0,0,0,0.0,0.0,0.0
moneda,2,1,2,5,40.0,20.0,40.0
cytecoin,1,0,1,2,50.0,0.0,50.0
bitlumens,1,0,3,4,25.0,0.0,75.0
union,24,10,51,85,28.235294117647058,11.76470588235294,60.0
bhom,0,6,0,6,0.0,100.0,0.0
potentiam,1,2,1,4,25.0,50.0,25.0
emrify,0,0,0,0,0.0,0.0,0.0
hai project,1,0,0,1,100.0,0.0,0.0
langnet,2,0,0,2,100.0,0.0,0.0
ambr,0,0,0,0,0.0,0.0,0.0
snovio,0,0,0,0,0.0,0.0,0.0
alvalor,0,1,0,1,0.0,100.0,0.0
triggmine,0,0,0,0,0.0,0.0,0.0
thorium,0,1,0,1,0.0,100.0,0.0
sport x,0,0,0,0,0.0,0.0,0.0
mos,2,1,1,4,50.0,25.0,25.0
vrt world,0,0,0,0,0.0,0.0,0.0
dateme,0,0,0,0,0.0,0.0,0.0
helios protocol,0,0,0,0,0.0,0.0,0.0
gravity gzro,0,0,0,0,0.0,0.0,0.0
gosama,3,0,0,3,100.0,0.0,0.0
laneaxis,0,0,0,0,0.0,0.0,0.0
cryptto,1,0,5,6,16.666666666666664,0.0,83.33333333333334
sleecoin,0,0,0,0,0.0,0.0,0.0
nau,0,0,0,0,0.0,0.0,0.0
trigid,0,0,0,0,0.0,0.0,0.0
vechain,24,29,17,70,34.285714285714285,41.42857142857143,24.285714285714285
nwp solution,0,0,0,0,0.0,0.0,0.0
kinguin,0,0,0,0,0.0,0.0,0.0
goldiam,4,0,0,4,100.0,0.0,0.0
first trading ecosystem,0,0,0,0,0.0,0.0,0.0
cybereits,0,0,0,0,0.0,0.0,0.0
blocknubie,0,0,0,0,0.0,0.0,0.0
hold,236,154,323,713,33.09957924263674,21.598877980364655,45.3015427769986
bcharity,0,0,0,0,0.0,0.0,0.0
alax,0,0,0,0,0.0,0.0,0.0
blockchain hotels 2.0,0,0,0,0,0.0,0.0,0.0
crypto angel,0,0,0,0,0.0,0.0,0.0
flashmoni,4,0,1,5,80.0,0.0,20.0
blackfol.io,0,0,0,0,0.0,0.0,0.0
disciplina,0,2,1,3,0.0,66.66666666666666,33.33333333333333
birake,0,0,0,0,0.0,0.0,0.0
extracredit,0,0,0,0,0.0,0.0,0.0
howdoo,0,0,0,0,0.0,0.0,0.0
sancoj,0,0,0,0,0.0,0.0,0.0
smart unit,0,0,0,0,0.0,0.0,0.0
papyrus,2,2,1,5,40.0,40.0,20.0
weicrowd,0,0,0,0,0.0,0.0,0.0
talao,0,0,0,0,0.0,0.0,0.0
etheal,0,0,0,0,0.0,0.0,0.0
stasyq,0,0,0,0,0.0,0.0,0.0
btu protocol,1,0,0,1,100.0,0.0,0.0
pantos by bitpanda,0,0,0,0,0.0,0.0,0.0
safein,0,0,0,0,0.0,0.0,0.0
eniac network,0,0,0,0,0.0,0.0,0.0
fox trading,0,0,4,4,0.0,0.0,100.0
decibels,0,0,0,0,0.0,0.0,0.0
mf chain,0,0,0,0,0.0,0.0,0.0
cryptelo,0,0,1,1,0.0,0.0,100.0
cartel,0,0,43,43,0.0,0.0,100.0
bobâs repair,0,0,0,0,0.0,0.0,0.0
measurable data token,0,0,0,0,0.0,0.0,0.0
blok,1,0,0,1,100.0,0.0,0.0
adsigma,0,0,0,0,0.0,0.0,0.0
payvx,0,0,0,0,0.0,0.0,0.0
instant assets tokens,0,0,0,0,0.0,0.0,0.0
algebraix,0,0,0,0,0.0,0.0,0.0
chimaera,0,0,0,0,0.0,0.0,0.0
essentia,0,0,0,0,0.0,0.0,0.0
pibble,0,3,4,7,0.0,42.857142857142854,57.14285714285714
echarge,0,0,0,0,0.0,0.0,0.0
flux,3,2,4,9,33.33333333333333,22.22222222222222,44.44444444444444
lapo,0,0,0,0,0.0,0.0,0.0
verime,0,0,0,0,0.0,0.0,0.0
crestonium,0,0,0,0,0.0,0.0,0.0
os university,0,0,0,0,0.0,0.0,0.0
friend unifying platform,0,0,0,0,0.0,0.0,0.0
photochain,0,0,0,0,0.0,0.0,0.0
aeternum,1,1,7,9,11.11111111111111,11.11111111111111,77.77777777777779
xmoneta,0,0,0,0,0.0,0.0,0.0
aphelion,0,0,0,0,0.0,0.0,0.0
koios,1,2,1,4,25.0,50.0,25.0
blockshipping,0,0,0,0,0.0,0.0,0.0
aida service,0,0,0,0,0.0,0.0,0.0
trifid,2,5,1,8,25.0,62.5,12.5
darcmatter,0,0,0,0,0.0,0.0,0.0
signals,3,6,14,23,13.043478260869565,26.08695652173913,60.86956521739131
oyster shell,0,0,0,0,0.0,0.0,0.0
cashbag,0,0,2,2,0.0,0.0,100.0
viola,2,1,1,4,50.0,25.0,25.0
cappasity,0,0,0,0,0.0,0.0,0.0
biograffi,0,0,0,0,0.0,0.0,0.0
gluon,5,4,8,17,29.411764705882355,23.52941176470588,47.05882352941176
fishcoin,0,0,1,1,0.0,0.0,100.0
bzlcoin,0,0,0,0,0.0,0.0,0.0
a2b taxi,0,0,0,0,0.0,0.0,0.0
monanex,2,0,2,4,50.0,0.0,50.0
gladius,0,0,0,0,0.0,0.0,0.0
elementh,0,0,0,0,0.0,0.0,0.0
callisto,0,0,1,1,0.0,0.0,100.0
cibus,5,2,2,9,55.55555555555556,22.22222222222222,22.22222222222222
connectjob,0,0,0,0,0.0,0.0,0.0
bitnautic,0,0,0,0,0.0,0.0,0.0
woter,0,0,0,0,0.0,0.0,0.0
ethearnal,4,0,3,7,57.14285714285714,0.0,42.857142857142854
bitcore,0,1,0,1,0.0,100.0,0.0
game loot network,0,0,0,0,0.0,0.0,0.0
mydfs,1,0,0,1,100.0,0.0,0.0
semux,2,3,2,7,28.57142857142857,42.857142857142854,28.57142857142857
storweey,1,0,0,1,100.0,0.0,0.0
war field,1,0,0,1,100.0,0.0,0.0
leonardian,0,0,0,0,0.0,0.0,0.0
cornucopia,0,1,0,1,0.0,100.0,0.0
tutellus,0,0,0,0,0.0,0.0,0.0
corl,0,0,0,0,0.0,0.0,0.0
prandex,1,0,0,1,100.0,0.0,0.0
dizcovery network,6,0,0,6,100.0,0.0,0.0
blockfollow,0,0,0,0,0.0,0.0,0.0
webrunes,0,0,0,0,0.0,0.0,0.0
invest in brokers,0,0,0,0,0.0,0.0,0.0
apollochain,4,3,0,7,57.14285714285714,42.857142857142854,0.0
urunit,0,0,0,0,0.0,0.0,0.0
allstocks,1,0,0,1,100.0,0.0,0.0
