airdrop_name,positive,neutral,negative,total,positive_percentage,neutral_percentage,negative_percentage
corridor finance,0,0,0,0,0.0,0.0,0.0
nyan heroes,1,0,1,2,50.0,0.0,50.0
cyber,27,0,64,91,29.67032967032967,0.0,70.32967032967034
ouinex,0,0,0,0,0.0,0.0,0.0
zksync,52,0,88,140,37.142857142857146,0.0,62.857142857142854
dogs,34,0,88,122,27.86885245901639,0.0,72.1311475409836
pontem,0,0,0,0,0.0,0.0,0.0
ether.fi,3,0,3,6,50.0,0.0,50.0
ostium,0,0,0,0,0.0,0.0,0.0
ancient8,1,0,0,1,100.0,0.0,0.0
usual,181,0,589,770,23.506493506493506,0.0,76.49350649350649
blastup,1,0,5,6,16.666666666666664,0.0,83.33333333333334
base,505,0,1653,2158,23.40129749768304,0.0,76.59870250231697
reactor fusion,0,0,0,0,0.0,0.0,0.0
merkle trade,0,0,0,0,0.0,0.0,0.0
pancakeswap,9,0,46,55,16.363636363636363,0.0,83.63636363636363
myx,6,0,16,22,27.27272727272727,0.0,72.72727272727273
ibx,4,0,18,22,18.181818181818183,0.0,81.81818181818183
texture,17,0,30,47,36.17021276595745,0.0,63.829787234042556
vaultcraft,0,0,0,0,0.0,0.0,0.0
newtify,0,0,0,0,0.0,0.0,0.0
grass,30,0,51,81,37.03703703703704,0.0,62.96296296296296
lavarage,0,0,0,0,0.0,0.0,0.0
scroll,22,0,70,92,23.91304347826087,0.0,76.08695652173914
swords & dungeons,0,0,0,0,0.0,0.0,0.0
rain.fi,0,0,2,2,0.0,0.0,100.0
macaron,1,0,7,8,12.5,0.0,87.5
clone,11,0,52,63,17.46031746031746,0.0,82.53968253968253
symbiotic,5,0,3,8,62.5,0.0,37.5
superboring,0,0,0,0,0.0,0.0,0.0
mocaverse,0,0,0,0,0.0,0.0,0.0
allora,1,0,6,7,14.285714285714285,0.0,85.71428571428571
jupiter,4,0,6,10,40.0,0.0,60.0
kroma,1,0,4,5,20.0,0.0,80.0
amphor,0,0,0,0,0.0,0.0,0.0
li.fi,0,0,2,2,0.0,0.0,100.0
zkcandy,0,0,0,0,0.0,0.0,0.0
napier finance,0,0,0,0,0.0,0.0,0.0
gate.io,3,0,15,18,16.666666666666664,0.0,83.33333333333334
sunrise,1,0,4,5,20.0,0.0,80.0
debank,0,0,1,1,0.0,0.0,100.0
rage trade,0,0,4,4,0.0,0.0,100.0
zircuit,5,0,1,6,83.33333333333334,0.0,16.666666666666664
super champs,0,0,0,0,0.0,0.0,0.0
injera,5,0,2,7,71.42857142857143,0.0,28.57142857142857
predx,0,0,0,0,0.0,0.0,0.0
units,30,0,88,118,25.423728813559322,0.0,74.57627118644068
camp network,0,0,0,0,0.0,0.0,0.0
rivalz network,5,0,4,9,55.55555555555556,0.0,44.44444444444444
10k dex,0,0,2,2,0.0,0.0,100.0
squid,16,0,33,49,32.6530612244898,0.0,67.3469387755102
goat gaming,0,0,0,0,0.0,0.0,0.0
hybrid,29,0,31,60,48.333333333333336,0.0,51.66666666666667
lazyotter,0,0,0,0,0.0,0.0,0.0
zerion,0,0,1,1,0.0,0.0,100.0
chirp,9,0,16,25,36.0,0.0,64.0
zebra,6,0,9,15,40.0,0.0,60.0
ai gram,0,0,0,0,0.0,0.0,0.0
cog finance,0,0,0,0,0.0,0.0,0.0
stakestone,2,0,1,3,66.66666666666666,0.0,33.33333333333333
mantle,11,0,36,47,23.404255319148938,0.0,76.59574468085107
superposition,2,0,7,9,22.22222222222222,0.0,77.77777777777779
symmetry trade,0,0,0,0,0.0,0.0,0.0
adrena,10,0,10,20,50.0,0.0,50.0
movement,73,0,126,199,36.68341708542713,0.0,63.31658291457286
nx finance,1,0,1,2,50.0,0.0,50.0
superposition finance,0,0,0,0,0.0,0.0,0.0
ora,502,0,1602,2104,23.859315589353614,0.0,76.14068441064639
gammaswap,0,0,0,0,0.0,0.0,0.0
unite,30,0,79,109,27.522935779816514,0.0,72.47706422018348
shardeum,0,0,0,0,0.0,0.0,0.0
echelon,1,0,3,4,25.0,0.0,75.0
rho markets,0,0,1,1,0.0,0.0,100.0
rainbow,13,0,20,33,39.39393939393939,0.0,60.60606060606061
zeta,2,0,7,9,22.22222222222222,0.0,77.77777777777779
optopia,0,0,2,2,0.0,0.0,100.0
blast,43,0,66,109,39.44954128440367,0.0,60.550458715596335
zeek network,0,0,0,0,0.0,0.0,0.0
summer.fi,0,0,5,5,0.0,0.0,100.0
infinex,0,0,1,1,0.0,0.0,100.0
mitosis,1,0,3,4,25.0,0.0,75.0
sophon,0,0,0,0,0.0,0.0,0.0
voi network,1,0,3,4,25.0,0.0,75.0
nftperp,0,0,11,11,0.0,0.0,100.0
hyperlane,2,0,3,5,40.0,0.0,60.0
nuri exchange,0,0,0,0,0.0,0.0,0.0
f(x) protocol,0,0,0,0,0.0,0.0,0.0
the backwoods,0,0,0,0,0.0,0.0,0.0
kinetix finance,0,0,0,0,0.0,0.0,0.0
binance,88,0,294,382,23.036649214659686,0.0,76.96335078534031
layerzero,0,0,1,1,0.0,0.0,100.0
eigenlayer,4,0,10,14,28.57142857142857,0.0,71.42857142857143
vest,647,0,1848,2495,25.931863727454914,0.0,74.06813627254509
koi finance,1,0,0,1,100.0,0.0,0.0
100x,27,0,66,93,29.03225806451613,0.0,70.96774193548387
degen war$,0,0,0,0,0.0,0.0,0.0
cherry,12,0,21,33,36.36363636363637,0.0,63.63636363636363
zest protocol,1,0,2,3,33.33333333333333,0.0,66.66666666666666
catalyst,5,0,40,45,11.11111111111111,0.0,88.88888888888889
renzo,2,0,0,2,100.0,0.0,0.0
mercle,0,0,0,0,0.0,0.0,0.0
griffinai,1,0,2,3,33.33333333333333,0.0,66.66666666666666
captain & company,0,0,0,0,0.0,0.0,0.0
iotex,7,0,17,24,29.166666666666668,0.0,70.83333333333334
orderly network,0,0,1,1,0.0,0.0,100.0
sui,90,0,354,444,20.27027027027027,0.0,79.72972972972973
cochilli,0,0,0,0,0.0,0.0,0.0
fhenix,1,0,1,2,50.0,0.0,50.0
avantis,12,0,20,32,37.5,0.0,62.5
debridge,0,0,0,0,0.0,0.0,0.0
aethir,1,0,10,11,9.090909090909092,0.0,90.9090909090909
glyph,1,0,2,3,33.33333333333333,0.0,66.66666666666666
0xastra,0,0,0,0,0.0,0.0,0.0
sofa,11,0,24,35,31.428571428571427,0.0,68.57142857142857
taiko,1,0,3,4,25.0,0.0,75.0
revert,2,0,30,32,6.25,0.0,93.75
nexis network,1,0,0,1,100.0,0.0,0.0
bitflow,3,0,6,9,33.33333333333333,0.0,66.66666666666666
kip protocol,0,0,1,1,0.0,0.0,100.0
dunes,4,0,22,26,15.384615384615385,0.0,84.61538461538461
biokript,1,0,0,1,100.0,0.0,0.0
d8x,0,0,0,0,0.0,0.0,0.0
fuel,33,0,70,103,32.038834951456316,0.0,67.96116504854369
rize,87,0,212,299,29.09698996655518,0.0,70.90301003344482
jigsaw,2,0,7,9,22.22222222222222,0.0,77.77777777777779
turtle club,4,0,6,10,40.0,0.0,60.0
rivo.xyz,0,0,0,0,0.0,0.0,0.0
gm network,0,0,0,0,0.0,0.0,0.0
pocket protector,1,0,2,3,33.33333333333333,0.0,66.66666666666666
olive network,0,0,1,1,0.0,0.0,100.0
zaros,4,0,8,12,33.33333333333333,0.0,66.66666666666666
avarik saga,0,0,0,0,0.0,0.0,0.0
forma,461,0,1461,1922,23.985431841831424,0.0,76.01456815816857
gaianet,0,0,0,0,0.0,0.0,0.0
alienx,0,0,4,4,0.0,0.0,100.0
hyperliquid,0,0,2,2,0.0,0.0,100.0
onchain,6,0,7,13,46.15384615384615,0.0,53.84615384615385
syrup,1,0,1,2,50.0,0.0,50.0
sender labs,0,0,0,0,0.0,0.0,0.0
ithaca protocol,0,0,0,0,0.0,0.0,0.0
marginly,0,0,0,0,0.0,0.0,0.0
anichess,0,0,0,0,0.0,0.0,0.0
equation,7,0,30,37,18.91891891891892,0.0,81.08108108108108
quantcheck,0,0,0,0,0.0,0.0,0.0
nekodex,0,0,2,2,0.0,0.0,100.0
solayer,2,0,19,21,9.523809523809524,0.0,90.47619047619048
fantasy top,0,0,0,0,0.0,0.0,0.0
anzen,0,0,7,7,0.0,0.0,100.0
evaa protocol,0,0,0,0,0.0,0.0,0.0
eigenpie,0,0,0,0,0.0,0.0,0.0
oasis ai,0,0,3,3,0.0,0.0,100.0
nexo,3,0,11,14,21.428571428571427,0.0,78.57142857142857
cex.io,13,0,40,53,24.528301886792452,0.0,75.47169811320755
pencils protocol,0,0,0,0,0.0,0.0,0.0
plume network,0,0,2,2,0.0,0.0,100.0
cryptopia,3,0,4,7,42.857142857142854,0.0,57.14285714285714
opengpu network,0,0,0,0,0.0,0.0,0.0
iskra,0,0,0,0,0.0,0.0,0.0
lingo,1,0,6,7,14.285714285714285,0.0,85.71428571428571
gravita protocol,3,0,1,4,75.0,0.0,25.0
initia,104,0,284,388,26.804123711340207,0.0,73.19587628865979
token metrics,0,0,0,0,0.0,0.0,0.0
gamium,1,0,5,6,16.666666666666664,0.0,83.33333333333334
agora,3,0,24,27,11.11111111111111,0.0,88.88888888888889
liquidium,0,0,0,0,0.0,0.0,0.0
autolayer,2,0,2,4,50.0,0.0,50.0
ethermail,0,0,1,1,0.0,0.0,100.0
vooi,0,0,3,3,0.0,0.0,100.0
lyra,0,0,2,2,0.0,0.0,100.0
tea,1225,0,2432,3657,33.497402242275086,0.0,66.50259775772491
m2,5,0,66,71,7.042253521126761,0.0,92.95774647887323
eywa,8,0,13,21,38.095238095238095,0.0,61.904761904761905
delabs games,0,0,0,0,0.0,0.0,0.0
dwinity,0,0,0,0,0.0,0.0,0.0
thetanuts finance,0,0,0,0,0.0,0.0,0.0
world pvp,2,0,0,2,100.0,0.0,0.0
thruster,1,0,1,2,50.0,0.0,50.0
tari,75,0,223,298,25.16778523489933,0.0,74.83221476510067
imaginary ones,0,0,0,0,0.0,0.0,0.0
glacier network,0,0,0,0,0.0,0.0,0.0
zyfi,0,0,3,3,0.0,0.0,100.0
storm trade,0,0,0,0,0.0,0.0,0.0
phaver,0,0,0,0,0.0,0.0,0.0
elfin,0,0,0,0,0.0,0.0,0.0
masa,3,0,6,9,33.33333333333333,0.0,66.66666666666666
spacecatch,0,0,0,0,0.0,0.0,0.0
mande network,0,0,0,0,0.0,0.0,0.0
xtremeverse,0,0,6,6,0.0,0.0,100.0
fyde,0,0,6,6,0.0,0.0,100.0
ekubo,4,0,1,5,80.0,0.0,20.0
caga,0,0,18,18,0.0,0.0,100.0
sanctum,16,0,33,49,32.6530612244898,0.0,67.3469387755102
zkpass,1,0,0,1,100.0,0.0,0.0
my lovely planet,0,0,0,0,0.0,0.0,0.0
tabi,48,0,171,219,21.91780821917808,0.0,78.08219178082192
mode,503,0,1819,2322,21.66236003445306,0.0,78.33763996554694
particle network,0,0,1,1,0.0,0.0,100.0
xswap,0,0,0,0,0.0,0.0,0.0
zerolend,0,0,1,1,0.0,0.0,100.0
aperture finance,0,0,1,1,0.0,0.0,100.0
myth,37,0,75,112,33.035714285714285,0.0,66.96428571428571
immutable,4,0,56,60,6.666666666666667,0.0,93.33333333333333
drift protocol,0,0,0,0,0.0,0.0,0.0
another-1,0,0,0,0,0.0,0.0,0.0
raiinmaker,0,0,0,0,0.0,0.0,0.0
blackwing,9,0,12,21,42.857142857142854,0.0,57.14285714285714
kamino,1,0,7,8,12.5,0.0,87.5
saltwater games,1,0,0,1,100.0,0.0,0.0
uprock,3,0,3,6,50.0,0.0,50.0
lunarstorm,1,0,10,11,9.090909090909092,0.0,90.9090909090909
revolving games,0,0,0,0,0.0,0.0,0.0
planetquest,0,0,2,2,0.0,0.0,100.0
zoth,9,0,15,24,37.5,0.0,62.5
intentx,0,0,0,0,0.0,0.0,0.0
befi labs,0,0,0,0,0.0,0.0,0.0
reya network,0,0,0,0,0.0,0.0,0.0
moongate,0,0,0,0,0.0,0.0,0.0
pixelverse,0,0,0,0,0.0,0.0,0.0
apillon,0,0,0,0,0.0,0.0,0.0
bemo,0,0,2,2,0.0,0.0,100.0
milkyway,0,0,2,2,0.0,0.0,100.0
astaria,0,0,0,0,0.0,0.0,0.0
bsx,0,0,0,0,0.0,0.0,0.0
orangelayer,0,0,0,0,0.0,0.0,0.0
inceptionlrt,0,0,0,0,0.0,0.0,0.0
mantra,2,0,7,9,22.22222222222222,0.0,77.77777777777779
bouncebit,1,0,5,6,16.666666666666664,0.0,83.33333333333334
blastoff,3,0,1,4,75.0,0.0,25.0
soarchain,0,0,1,1,0.0,0.0,100.0
elixir,2,0,4,6,33.33333333333333,0.0,66.66666666666666
omni network,1,0,0,1,100.0,0.0,0.0
solv protocol,2,0,4,6,33.33333333333333,0.0,66.66666666666666
planet mojo,5,0,3,8,62.5,0.0,37.5
parcl,1,0,11,12,8.333333333333332,0.0,91.66666666666666
dtx,8,0,17,25,32.0,0.0,68.0
ultimate digits,0,0,0,0,0.0,0.0,0.0
mpro lab,0,0,0,0,0.0,0.0,0.0
tensor,2,0,6,8,25.0,0.0,75.0
pac finance,0,0,2,2,0.0,0.0,100.0
overtrip,0,0,0,0,0.0,0.0,0.0
blockgames,0,0,1,1,0.0,0.0,100.0
warden protocol,0,0,0,0,0.0,0.0,0.0
base name service,0,0,0,0,0.0,0.0,0.0
scallop,0,0,1,1,0.0,0.0,100.0
synfutures,0,0,0,0,0.0,0.0,0.0
starrynift,3,0,2,5,60.0,0.0,40.0
wormhole,4,0,6,10,40.0,0.0,60.0
hava coin,0,0,1,1,0.0,0.0,100.0
battle showdown: gambit,0,0,0,0,0.0,0.0,0.0
ethena,5,0,4,9,55.55555555555556,0.0,44.44444444444444
data ownership protocol,3,0,1,4,75.0,0.0,25.0
pryzm,1,0,3,4,25.0,0.0,75.0
coti,2,0,8,10,20.0,0.0,80.0
a51,2,0,10,12,16.666666666666664,0.0,83.33333333333334
zke exchange,0,0,0,0,0.0,0.0,0.0
sharpe,16,0,20,36,44.44444444444444,0.0,55.55555555555556
aries markets,0,0,0,0,0.0,0.0,0.0
elys network,0,0,2,2,0.0,0.0,100.0
haven1,0,0,0,0,0.0,0.0,0.0
helix,7,0,32,39,17.94871794871795,0.0,82.05128205128204
kelp dao,1,0,1,2,50.0,0.0,50.0
myswap,0,0,2,2,0.0,0.0,100.0
braavos,0,0,0,0,0.0,0.0,0.0
tortuga finance,0,0,0,0,0.0,0.0,0.0
bnb chain,2,0,5,7,28.57142857142857,0.0,71.42857142857143
aptin finance,0,0,0,0,0.0,0.0,0.0
unirouter,0,0,2,2,0.0,0.0,100.0
bitget wallet,7,0,14,21,33.33333333333333,0.0,66.66666666666666
aptos,3,0,4,7,42.857142857142854,0.0,57.14285714285714
beoble,0,0,0,0,0.0,0.0,0.0
param gaming,2,0,0,2,100.0,0.0,0.0
xyro,0,0,0,0,0.0,0.0,0.0
plena,0,0,0,0,0.0,0.0,0.0
polyhedra network,3,0,1,4,75.0,0.0,25.0
dflow,0,0,3,3,0.0,0.0,100.0
zklend,0,0,0,0,0.0,0.0,0.0
defispot,2,0,2,4,50.0,0.0,50.0
boson protocol,0,0,0,0,0.0,0.0,0.0
metis,0,0,0,0,0.0,0.0,0.0
districtone,0,0,1,1,0.0,0.0,100.0
layer3,0,0,2,2,0.0,0.0,100.0
entangle,2,0,6,8,25.0,0.0,75.0
panther protocol,0,0,0,0,0.0,0.0,0.0
memecoin,7,0,32,39,17.94871794871795,0.0,82.05128205128204
teller,11,0,15,26,42.30769230769231,0.0,57.692307692307686
gomble games,0,0,0,0,0.0,0.0,0.0
parallel network,0,0,1,1,0.0,0.0,100.0
venom,2,0,17,19,10.526315789473683,0.0,89.47368421052632
synthr,0,0,0,0,0.0,0.0,0.0
wen exchange,0,0,0,0,0.0,0.0,0.0
yolo games,0,0,0,0,0.0,0.0,0.0
lava,5,0,24,29,17.24137931034483,0.0,82.75862068965517
invarch,0,0,0,0,0.0,0.0,0.0
kiloex,0,0,2,2,0.0,0.0,100.0
hana network,0,0,0,0,0.0,0.0,0.0
metastreet,1,0,1,2,50.0,0.0,50.0
nulink,1,0,4,5,20.0,0.0,80.0
ambit finance,2,0,1,3,66.66666666666666,0.0,33.33333333333333
smart layer,1,0,1,2,50.0,0.0,50.0
mon protocol,0,0,1,1,0.0,0.0,100.0
rio network,0,0,0,0,0.0,0.0,0.0
optimism,11,0,20,31,35.483870967741936,0.0,64.51612903225806
blaster,2,0,2,4,50.0,0.0,50.0
starknet,6,0,7,13,46.15384615384615,0.0,53.84615384615385
altlayer,1,0,0,1,100.0,0.0,0.0
pixels,3,0,11,14,21.428571428571427,0.0,78.57142857142857
aftermath finance,0,0,0,0,0.0,0.0,0.0
avnu,1,0,2,3,33.33333333333333,0.0,66.66666666666666
bluefin,16,0,12,28,57.14285714285714,0.0,42.857142857142854
overlay protocol,0,0,0,0,0.0,0.0,0.0
claystack,1,0,2,3,33.33333333333333,0.0,66.66666666666666
retro bridge,1,0,0,1,100.0,0.0,0.0
dymension,1,0,1,2,50.0,0.0,50.0
init capital,0,0,0,0,0.0,0.0,0.0
bâ² network,0,0,0,0,0.0,0.0,0.0
pike,14,0,66,80,17.5,0.0,82.5
zetachain,1,0,0,1,100.0,0.0,0.0
partisia blockchain,0,0,0,0,0.0,0.0,0.0
aether,4,0,6,10,40.0,0.0,60.0
nostra,4,0,8,12,33.33333333333333,0.0,66.66666666666666
edexa,0,0,0,0,0.0,0.0,0.0
undeads,0,0,0,0,0.0,0.0,0.0
aether games,1,0,0,1,100.0,0.0,0.0
dmail network,0,0,0,0,0.0,0.0,0.0
presearch,2,0,3,5,40.0,0.0,60.0
bitcoin virtual machine,0,0,1,1,0.0,0.0,100.0
stackingdao,5,0,13,18,27.77777777777778,0.0,72.22222222222221
navi protocol,0,0,1,1,0.0,0.0,100.0
mind network,0,0,1,1,0.0,0.0,100.0
xion,2,0,4,6,33.33333333333333,0.0,66.66666666666666
ready to fight,0,0,0,0,0.0,0.0,0.0
brc-20 dex,0,0,0,0,0.0,0.0,0.0
web3go,0,0,0,0,0.0,0.0,0.0
eesee,0,0,1,1,0.0,0.0,100.0
unigraph protocol,0,0,0,0,0.0,0.0,0.0
virtual labs,0,0,0,0,0.0,0.0,0.0
manta network,0,0,0,0,0.0,0.0,0.0
sound.xyz,0,0,2,2,0.0,0.0,100.0
reveel,0,0,2,2,0.0,0.0,100.0
carv,11,0,26,37,29.72972972972973,0.0,70.27027027027027
swell,19,0,33,52,36.53846153846153,0.0,63.46153846153846
frame,61,0,167,228,26.75438596491228,0.0,73.24561403508771
teleportdao,3,0,2,5,60.0,0.0,40.0
seamless protocol,0,0,0,0,0.0,0.0,0.0
brc20,2,0,4,6,33.33333333333333,0.0,66.66666666666666
kinza finance,0,0,0,0,0.0,0.0,0.0
elusiv,2,0,11,13,15.384615384615385,0.0,84.61538461538461
marinade,1,0,3,4,25.0,0.0,75.0
jito,2,0,1,3,66.66666666666666,0.0,33.33333333333333
term structure,2,0,4,6,33.33333333333333,0.0,66.66666666666666
hinkal,0,0,1,1,0.0,0.0,100.0
patex,0,0,0,0,0.0,0.0,0.0
pyth network,0,0,0,0,0.0,0.0,0.0
meuna,0,0,2,2,0.0,0.0,100.0
satori,0,0,0,0,0.0,0.0,0.0
marginfi,0,0,3,3,0.0,0.0,100.0
scroll name service,0,0,0,0,0.0,0.0,0.0
aori,6,0,7,13,46.15384615384615,0.0,53.84615384615385
grvt,1,0,0,1,100.0,0.0,0.0
shanhai,1,0,8,9,11.11111111111111,0.0,88.88888888888889
tezos domains,0,0,0,0,0.0,0.0,0.0
derivio,0,0,1,1,0.0,0.0,100.0
celestia,2,0,13,15,13.333333333333334,0.0,86.66666666666667
bluelight,0,0,0,0,0.0,0.0,0.0
forcefi,0,0,0,0,0.0,0.0,0.0
juice,17,0,20,37,45.94594594594595,0.0,54.054054054054056
karak,14,0,24,38,36.84210526315789,0.0,63.1578947368421
redstone,2,0,3,5,40.0,0.0,60.0
okx,4,0,10,14,28.57142857142857,0.0,71.42857142857143
mangrove,4,0,3,7,57.14285714285714,0.0,42.857142857142854
altitude,1,0,8,9,11.11111111111111,0.0,88.88888888888889
ambient,4,0,5,9,44.44444444444444,0.0,55.55555555555556
connext,0,0,3,3,0.0,0.0,100.0
okto x quickswap,0,0,0,0,0.0,0.0,0.0
clipper,8,0,20,28,28.57142857142857,0.0,71.42857142857143
moonlandmeta,0,0,0,0,0.0,0.0,0.0
basilisk,4,0,12,16,25.0,0.0,75.0
lightlink,3,0,6,9,33.33333333333333,0.0,66.66666666666666
extra finance,1,0,2,3,33.33333333333333,0.0,66.66666666666666
chainflip,1,0,4,5,20.0,0.0,80.0
web3eco,0,0,0,0,0.0,0.0,0.0
hubble exchange,0,0,0,0,0.0,0.0,0.0
hmx,6,0,12,18,33.33333333333333,0.0,66.66666666666666
meld,3,0,5,8,37.5,0.0,62.5
worldcoin,7,0,12,19,36.84210526315789,0.0,63.1578947368421
dx25,0,0,0,0,0.0,0.0,0.0
tsunami finance,0,0,4,4,0.0,0.0,100.0
tapiocadao,0,0,0,0,0.0,0.0,0.0
archway,0,0,0,0,0.0,0.0,0.0
zksync id,0,0,0,0,0.0,0.0,0.0
polygon zkevm,0,0,0,0,0.0,0.0,0.0
diva,2,0,6,8,25.0,0.0,75.0
vela exchange,2,0,0,2,100.0,0.0,0.0
letit,0,0,0,0,0.0,0.0,0.0
whitebit,0,0,0,0,0.0,0.0,0.0
maverick protocol,4,0,3,7,57.14285714285714,0.0,42.857142857142854
tevaera,0,0,0,0,0.0,0.0,0.0
velar,2,0,4,6,33.33333333333333,0.0,66.66666666666666
lunafi,0,0,0,0,0.0,0.0,0.0
dboe,0,0,0,0,0.0,0.0,0.0
range protocol,0,0,0,0,0.0,0.0,0.0
cedro finance,0,0,0,0,0.0,0.0,0.0
digifinex,0,0,1,1,0.0,0.0,100.0
bydfi,0,0,0,0,0.0,0.0,0.0
magic square,0,0,0,0,0.0,0.0,0.0
starknet id,0,0,0,0,0.0,0.0,0.0
aark digital,0,0,0,0,0.0,0.0,0.0
mufex,0,0,0,0,0.0,0.0,0.0
foxify,0,0,1,1,0.0,0.0,100.0
pulsechain,2,0,6,8,25.0,0.0,75.0
housebets.io,1,0,0,1,100.0,0.0,0.0
dexcheck,0,0,0,0,0.0,0.0,0.0
rebel bots,0,0,2,2,0.0,0.0,100.0
hord,8,0,42,50,16.0,0.0,84.0
cashmere,10,0,18,28,35.714285714285715,0.0,64.28571428571429
5irechain,0,0,0,0,0.0,0.0,0.0
zksync name service,0,0,0,0,0.0,0.0,0.0
yum yum,2,0,5,7,28.57142857142857,0.0,71.42857142857143
zkx,0,0,0,0,0.0,0.0,0.0
increment,2,0,15,17,11.76470588235294,0.0,88.23529411764706
the lost wallet,0,0,0,0,0.0,0.0,0.0
linea,28,0,88,116,24.137931034482758,0.0,75.86206896551724
polynomial protocol,0,0,0,0,0.0,0.0,0.0
syncswap,3,0,0,3,100.0,0.0,0.0
daoversal,0,0,0,0,0.0,0.0,0.0
velvet.capital,0,0,0,0,0.0,0.0,0.0
huma finance,1,0,0,1,100.0,0.0,0.0
snowcone,0,0,0,0,0.0,0.0,0.0
arbitrum,17,0,51,68,25.0,0.0,75.0
quasar,0,0,0,0,0.0,0.0,0.0
dune analytics,0,0,0,0,0.0,0.0,0.0
space id,0,0,0,0,0.0,0.0,0.0
legends of elysium,0,0,0,0,0.0,0.0,0.0
tide exchange,0,0,1,1,0.0,0.0,100.0
alienswap,0,0,5,5,0.0,0.0,100.0
zigzag,0,0,2,2,0.0,0.0,100.0
collab.land,2,0,13,15,13.333333333333334,0.0,86.66666666666667
nexon finance,0,0,0,0,0.0,0.0,0.0
ez finance,0,0,0,0,0.0,0.0,0.0
olive,7,0,14,21,33.33333333333333,0.0,66.66666666666666
enchanter finance,0,0,0,0,0.0,0.0,0.0
mayan,1,0,2,3,33.33333333333333,0.0,66.66666666666666
sudoswap,0,0,0,0,0.0,0.0,0.0
timeless,6,0,2,8,75.0,0.0,25.0
billionair,42,0,59,101,41.584158415841586,0.0,58.415841584158414
supraoracles,0,0,0,0,0.0,0.0,0.0
ipor,9,0,8,17,52.94117647058824,0.0,47.05882352941176
neptune mutual,0,0,0,0,0.0,0.0,0.0
nft3,2,0,1,3,66.66666666666666,0.0,33.33333333333333
demex,0,0,1,1,0.0,0.0,100.0
specular,0,0,0,0,0.0,0.0,0.0
hashstack,0,0,1,1,0.0,0.0,100.0
brine,3,0,14,17,17.647058823529413,0.0,82.35294117647058
v2x,6,0,6,12,50.0,0.0,50.0
supernova,1,0,4,5,20.0,0.0,80.0
bebop,0,0,0,0,0.0,0.0,0.0
kwiktrust,2,0,0,2,100.0,0.0,0.0
phi,452,0,1012,1464,30.87431693989071,0.0,69.12568306010928
plenty,94,0,293,387,24.289405684754524,0.0,75.71059431524549
swing,26,0,62,88,29.545454545454547,0.0,70.45454545454545
spectrum finance,0,0,0,0,0.0,0.0,0.0
harbor protocol,0,0,0,0,0.0,0.0,0.0
sentiment,25,0,57,82,30.48780487804878,0.0,69.51219512195121
vertex,0,0,0,0,0.0,0.0,0.0
voltz,7,0,9,16,43.75,0.0,56.25
objkt.com,1,0,9,10,10.0,0.0,90.0
titi protocol,0,0,0,0,0.0,0.0,0.0
jediswap,0,0,0,0,0.0,0.0,0.0
uniswap,10,0,47,57,17.543859649122805,0.0,82.45614035087719
across,142,0,276,418,33.97129186602871,0.0,66.02870813397129
mean finance,0,0,0,0,0.0,0.0,0.0
key app,0,0,3,3,0.0,0.0,100.0
paraspace,0,0,0,0,0.0,0.0,0.0
layerswap,0,0,6,6,0.0,0.0,100.0
aboard,1,0,4,5,20.0,0.0,80.0
mun,619,0,1147,1766,35.05096262740657,0.0,64.94903737259344
via protocol,0,0,0,0,0.0,0.0,0.0
chainhop,0,0,0,0,0.0,0.0,0.0
cega,0,0,0,0,0.0,0.0,0.0
wombat,10,0,8,18,55.55555555555556,0.0,44.44444444444444
mtg,10,0,103,113,8.849557522123893,0.0,91.1504424778761
arrakis finance,0,0,0,0,0.0,0.0,0.0
dolomite,1,0,9,10,10.0,0.0,90.0
deepwaters,0,0,0,0,0.0,0.0,0.0
bluemove,0,0,0,0,0.0,0.0,0.0
optifi,0,0,0,0,0.0,0.0,0.0
alpha road,0,0,0,0,0.0,0.0,0.0
sei,35,0,167,202,17.326732673267326,0.0,82.67326732673267
openchat,0,0,1,1,0.0,0.0,100.0
rabbitx,0,0,1,1,0.0,0.0,100.0
the granary,0,0,7,7,0.0,0.0,100.0
metaplex,0,0,1,1,0.0,0.0,100.0
tectum,0,0,0,0,0.0,0.0,0.0
onomy protocol,0,0,0,0,0.0,0.0,0.0
blur,13,0,34,47,27.659574468085108,0.0,72.3404255319149
trustless,7,0,38,45,15.555555555555555,0.0,84.44444444444444
verida,5,0,3,8,62.5,0.0,37.5
xai,4,0,2,6,66.66666666666666,0.0,33.33333333333333
commodo,4,0,14,18,22.22222222222222,0.0,77.77777777777779
stratos,2,0,3,5,40.0,0.0,60.0
teritori,0,0,1,1,0.0,0.0,100.0
xen crypto,0,0,0,0,0.0,0.0,0.0
binance account bound (bab),0,0,0,0,0.0,0.0,0.0
zkex,0,0,0,0,0.0,0.0,0.0
helio protocol,8,0,12,20,40.0,0.0,60.0
karate combat,0,0,0,0,0.0,0.0,0.0
conic finance,0,0,0,0,0.0,0.0,0.0
htx,0,0,9,9,0.0,0.0,100.0
odos,2,0,53,55,3.6363636363636362,0.0,96.36363636363636
ragnar protocol,0,0,0,0,0.0,0.0,0.0
allstars digital,0,0,0,0,0.0,0.0,0.0
kucoin,32,0,42,74,43.24324324324324,0.0,56.75675675675676
xiroverse,0,0,0,0,0.0,0.0,0.0
terran coin,0,0,0,0,0.0,0.0,0.0
quai network,0,0,0,0,0.0,0.0,0.0
dogechain,0,0,0,0,0.0,0.0,0.0
portal,16,0,35,51,31.372549019607842,0.0,68.62745098039215
cornerstone,1,0,0,1,100.0,0.0,0.0
stride,5,0,2,7,71.42857142857143,0.0,28.57142857142857
composable finance,0,0,1,1,0.0,0.0,100.0
strmnft,0,0,0,0,0.0,0.0,0.0
tegro,0,0,0,0,0.0,0.0,0.0
quix,4,0,6,10,40.0,0.0,60.0
bungee,0,0,2,2,0.0,0.0,100.0
stormgain,0,0,1,1,0.0,0.0,100.0
primex,1,0,0,1,100.0,0.0,0.0
tally ho,0,0,1,1,0.0,0.0,100.0
forta,88,0,145,233,37.76824034334764,0.0,62.231759656652365
sweat economy,0,0,0,0,0.0,0.0,0.0
zora,2,0,7,9,22.22222222222222,0.0,77.77777777777779
velodrome,0,0,2,2,0.0,0.0,100.0
chains,77,0,329,406,18.96551724137931,0.0,81.03448275862068
0vix,0,0,0,0,0.0,0.0,0.0
bonq,0,0,0,0,0.0,0.0,0.0
epsylon,1,0,2,3,33.33333333333333,0.0,66.66666666666666
ledn,2,0,11,13,15.384615384615385,0.0,84.61538461538461
realme,0,0,15,15,0.0,0.0,100.0
matrix,19,0,17,36,52.77777777777778,0.0,47.22222222222222
retrograde,0,0,2,2,0.0,0.0,100.0
hop protocol,0,0,1,1,0.0,0.0,100.0
gem,194,0,397,591,32.82571912013537,0.0,67.17428087986464
lend flare,0,0,1,1,0.0,0.0,100.0
armaldia,0,0,1,1,0.0,0.0,100.0
leap wallet,0,0,1,1,0.0,0.0,100.0
bridgesplit,1,0,0,1,100.0,0.0,0.0
fractional,4,0,17,21,19.047619047619047,0.0,80.95238095238095
nebula protocol,0,0,1,1,0.0,0.0,100.0
orbofi,1,0,0,1,100.0,0.0,0.0
styllar,5,0,1,6,83.33333333333334,0.0,16.666666666666664
crescent network,0,0,0,0,0.0,0.0,0.0
tangible,13,0,63,76,17.105263157894736,0.0,82.89473684210526
taki,288,0,835,1123,25.645592163846835,0.0,74.35440783615316
iotube,1,0,7,8,12.5,0.0,87.5
yobit,1,0,0,1,100.0,0.0,0.0
void protocol,0,0,1,1,0.0,0.0,100.0
vinci,13,0,54,67,19.402985074626866,0.0,80.59701492537313
element finance,0,0,0,0,0.0,0.0,0.0
landdao,0,0,0,0,0.0,0.0,0.0
cheqd,0,0,1,1,0.0,0.0,100.0
dao labs,0,0,0,0,0.0,0.0,0.0
unagii,5,0,13,18,27.77777777777778,0.0,72.22222222222221
nested,2,0,20,22,9.090909090909092,0.0,90.9090909090909
assetmantle,2,0,8,10,20.0,0.0,80.0
morpher,0,0,0,0,0.0,0.0,0.0
limewire,0,0,2,2,0.0,0.0,100.0
mars protocol,0,0,0,0,0.0,0.0,0.0
findora,0,0,0,0,0.0,0.0,0.0
likecoin,0,0,0,0,0.0,0.0,0.0
fuji dao,0,0,0,0,0.0,0.0,0.0
diffusion finance,0,0,0,0,0.0,0.0,0.0
pstake finance,0,0,0,0,0.0,0.0,0.0
partybid,0,0,0,0,0.0,0.0,0.0
frax,1,0,2,3,33.33333333333333,0.0,66.66666666666666
craft economy,0,0,0,0,0.0,0.0,0.0
x2y2,0,0,0,0,0.0,0.0,0.0
cowswap,0,0,0,0,0.0,0.0,0.0
orbiter finance,0,0,0,0,0.0,0.0,0.0
gameinfinity,1,0,0,1,100.0,0.0,0.0
katana,4,0,9,13,30.76923076923077,0.0,69.23076923076923
stargaze,2,0,5,7,28.57142857142857,0.0,71.42857142857143
trust domains,0,0,0,0,0.0,0.0,0.0
fraktal,1,0,6,7,14.285714285714285,0.0,85.71428571428571
votium,1,0,0,1,100.0,0.0,0.0
pika protocol,0,0,2,2,0.0,0.0,100.0
nomic,112,0,313,425,26.35294117647059,0.0,73.6470588235294
friktion,5,0,9,14,35.714285714285715,0.0,64.28571428571429
whalefin,0,0,0,0,0.0,0.0,0.0
sonic,6,0,29,35,17.142857142857142,0.0,82.85714285714286
quarry,0,0,2,2,0.0,0.0,100.0
omniflix,1,0,13,14,7.142857142857142,0.0,92.85714285714286
chic cow & bullzz,0,0,0,0,0.0,0.0,0.0
shell protocol,0,0,0,0,0.0,0.0,0.0
mintbase,0,0,0,0,0.0,0.0,0.0
legion network,0,0,0,0,0.0,0.0,0.0
rubicon,1,0,0,1,100.0,0.0,0.0
glow,20,0,20,40,50.0,0.0,50.0
coinhall,2,0,9,11,18.181818181818183,0.0,81.81818181818183
looksrare,0,0,0,0,0.0,0.0,0.0
stellarx,0,0,0,0,0.0,0.0,0.0
coreum,0,0,0,0,0.0,0.0,0.0
gas dao,0,0,0,0,0.0,0.0,0.0
astroport,28,0,3,31,90.32258064516128,0.0,9.67741935483871
aztec,1,0,2,3,33.33333333333333,0.0,66.66666666666666
terra name service,0,0,1,1,0.0,0.0,100.0
lum network,0,0,2,2,0.0,0.0,100.0
francium,0,0,3,3,0.0,0.0,100.0
icon,67,0,151,218,30.73394495412844,0.0,69.26605504587155
paras,9,0,32,41,21.951219512195124,0.0,78.04878048780488
iota,21,0,74,95,22.105263157894736,0.0,77.89473684210526
comdex,1,0,7,8,12.5,0.0,87.5
volmex,0,0,0,0,0.0,0.0,0.0
iexec,4,0,1,5,80.0,0.0,20.0
berachain,1,0,2,3,33.33333333333333,0.0,66.66666666666666
die last,0,0,0,0,0.0,0.0,0.0
rabby wallet,0,0,0,0,0.0,0.0,0.0
grindery,0,0,2,2,0.0,0.0,100.0
synonym,6,0,6,12,50.0,0.0,50.0
terra world,1,0,1,2,50.0,0.0,50.0
superfluid,0,0,0,0,0.0,0.0,0.0
hardcore fc,0,0,1,1,0.0,0.0,100.0
hedgehog markets,0,0,0,0,0.0,0.0,0.0
sablier,0,0,0,0,0.0,0.0,0.0
desmos,1,0,3,4,25.0,0.0,75.0
atrix,19,0,20,39,48.717948717948715,0.0,51.28205128205128
instrumental finance,0,0,0,0,0.0,0.0,0.0
tokensets,0,0,0,0,0.0,0.0,0.0
spintop,2,0,1,3,66.66666666666666,0.0,33.33333333333333
phantom,11,0,25,36,30.555555555555557,0.0,69.44444444444444
aquarius,1,0,0,1,100.0,0.0,0.0
saddle finance,0,0,0,0,0.0,0.0,0.0
dexguru,1,0,4,5,20.0,0.0,80.0
paraswap,2,0,2,4,50.0,0.0,50.0
matcha,0,0,1,1,0.0,0.0,100.0
solanart,0,0,2,2,0.0,0.0,100.0
foundation,72,0,161,233,30.90128755364807,0.0,69.09871244635193
digital arms,0,0,0,0,0.0,0.0,0.0
gro protocol,0,0,1,1,0.0,0.0,100.0
gridlock,0,0,1,1,0.0,0.0,100.0
paladin,6,0,13,19,31.57894736842105,0.0,68.42105263157895
apricot finance,0,0,0,0,0.0,0.0,0.0
sologenic,0,0,0,0,0.0,0.0,0.0
terrafloki,0,0,0,0,0.0,0.0,0.0
defi saver,0,0,1,1,0.0,0.0,100.0
oneof,2,0,12,14,14.285714285714285,0.0,85.71428571428571
bityard,0,0,0,0,0.0,0.0,0.0
zapper,1,0,1,2,50.0,0.0,50.0
human protocol,0,0,0,0,0.0,0.0,0.0
gaia everworld,0,0,1,1,0.0,0.0,100.0
sportemon go,0,0,0,0,0.0,0.0,0.0
yield protocol,0,0,0,0,0.0,0.0,0.0
cozy finance,0,0,1,1,0.0,0.0,100.0
timeswap,1,0,1,2,50.0,0.0,50.0
terra land,0,0,0,0,0.0,0.0,0.0
opyn,0,0,0,0,0.0,0.0,0.0
symmetry,5,0,7,12,41.66666666666667,0.0,58.333333333333336
apollo dao,1,0,3,4,25.0,0.0,75.0
solend,0,0,2,2,0.0,0.0,100.0
terraswap,0,0,12,12,0.0,0.0,100.0
talis protocol,1,0,2,3,33.33333333333333,0.0,66.66666666666666
flare finance,0,0,0,0,0.0,0.0,0.0
polymarket,0,0,0,0,0.0,0.0,0.0
valkyrie protocol,0,0,0,0,0.0,0.0,0.0
slingshot,0,0,1,1,0.0,0.0,100.0
opensea,6,0,24,30,20.0,0.0,80.0
shade protocol,0,0,1,1,0.0,0.0,100.0
roco finance,0,0,0,0,0.0,0.0,0.0
backd,0,0,27,27,0.0,0.0,100.0
loop,60,0,261,321,18.69158878504673,0.0,81.30841121495327
metamask,21,0,120,141,14.893617021276595,0.0,85.1063829787234
nexus protocol,0,0,1,1,0.0,0.0,100.0
boba network,0,0,0,0,0.0,0.0,0.0
portuma,2,0,0,2,100.0,0.0,0.0
brightid,1,0,1,2,50.0,0.0,50.0
inpoker,0,0,0,0,0.0,0.0,0.0
adshares,0,0,0,0,0.0,0.0,0.0
thales,0,0,1,1,0.0,0.0,100.0
foil network,0,0,0,0,0.0,0.0,0.0
songbird,0,0,1,1,0.0,0.0,100.0
tokel,0,0,0,0,0.0,0.0,0.0
bullionfx,2,0,3,5,40.0,0.0,60.0
juno,13,0,31,44,29.545454545454547,0.0,70.45454545454545
bitget,33,0,24,57,57.89473684210527,0.0,42.10526315789473
remitano,0,0,0,0,0.0,0.0,0.0
angel protocol,0,0,0,0,0.0,0.0,0.0
starterra,28,0,8,36,77.77777777777779,0.0,22.22222222222222
blockasset,0,0,0,0,0.0,0.0,0.0
superrare,0,0,0,0,0.0,0.0,0.0
hai damo,2,0,0,2,100.0,0.0,0.0
sunny,4,0,10,14,28.57142857142857,0.0,71.42857142857143
weyu,2,0,7,9,22.22222222222222,0.0,77.77777777777779
dydx,3,0,6,9,33.33333333333333,0.0,66.66666666666666
dfyn,0,0,0,0,0.0,0.0,0.0
notional,0,0,0,0,0.0,0.0,0.0
altair,0,0,0,0,0.0,0.0,0.0
shapeshift,0,0,6,6,0.0,0.0,100.0
thorswap,2,0,2,4,50.0,0.0,50.0
voltnft,0,0,0,0,0.0,0.0,0.0
openocean,0,0,0,0,0.0,0.0,0.0
nftb,0,0,0,0,0.0,0.0,0.0
hi,12883,0,31487,44370,29.035384268649988,0.0,70.96461573135001
tap,85,0,344,429,19.813519813519815,0.0,80.1864801864802
moonbet,0,0,0,0,0.0,0.0,0.0
spar finance,0,0,0,0,0.0,0.0,0.0
connect financial,1,0,0,1,100.0,0.0,0.0
osmosis,7,0,46,53,13.20754716981132,0.0,86.79245283018868
pylon protocol,26,0,0,26,100.0,0.0,0.0
gembites,0,0,0,0,0.0,0.0,0.0
earnbet,0,0,2,2,0.0,0.0,100.0
orion money,0,0,5,5,0.0,0.0,100.0
omni,11,0,44,55,20.0,0.0,80.0
emiswap,0,0,0,0,0.0,0.0,0.0
crd network,0,0,0,0,0.0,0.0,0.0
instadapp,0,0,0,0,0.0,0.0,0.0
degenâs farm,0,0,0,0,0.0,0.0,0.0
blockster,0,0,0,0,0.0,0.0,0.0
skyward finance,0,0,0,0,0.0,0.0,0.0
moonedge,7,0,3,10,70.0,0.0,30.0
neftipedia,0,0,0,0,0.0,0.0,0.0
thorstarter,0,0,0,0,0.0,0.0,0.0
arweave,1,0,3,4,25.0,0.0,75.0
apenft,1,0,12,13,7.6923076923076925,0.0,92.3076923076923
easybake,0,0,0,0,0.0,0.0,0.0
honeyswap,0,0,1,1,0.0,0.0,100.0
charged particles,0,0,0,0,0.0,0.0,0.0
bartertrade,0,0,1,1,0.0,0.0,100.0
ribbon finance,0,0,0,0,0.0,0.0,0.0
zoidpay,1,0,4,5,20.0,0.0,80.0
qiswap,0,0,0,0,0.0,0.0,0.0
crypto thrills,0,0,0,0,0.0,0.0,0.0
doren,5,0,0,5,100.0,0.0,0.0
solpad,1,0,16,17,5.88235294117647,0.0,94.11764705882352
convex finance,0,0,0,0,0.0,0.0,0.0
runnode,0,0,0,0,0.0,0.0,0.0
venus,5,0,2,7,71.42857142857143,0.0,28.57142857142857
chainx,1,0,1,2,50.0,0.0,50.0
revuto,0,0,0,0,0.0,0.0,0.0
solanium,0,0,0,0,0.0,0.0,0.0
impermax finance,0,0,0,0,0.0,0.0,0.0
avalaunch,0,0,12,12,0.0,0.0,100.0
etherlite,2,0,13,15,13.333333333333334,0.0,86.66666666666667
badger dao,0,0,0,0,0.0,0.0,0.0
deversifi,0,0,0,0,0.0,0.0,0.0
bribe,2,0,30,32,6.25,0.0,93.75
sora,0,0,6,6,0.0,0.0,100.0
maiar exchange,0,0,0,0,0.0,0.0,0.0
hopr,0,0,0,0,0.0,0.0,0.0
aladdin,1,0,2,3,33.33333333333333,0.0,66.66666666666666
klomp,0,0,0,0,0.0,0.0,0.0
nftmart,1,0,0,1,100.0,0.0,0.0
lotto,5,0,4,9,55.55555555555556,0.0,44.44444444444444
1inch,1,0,3,4,25.0,0.0,75.0
affine,2,0,24,26,7.6923076923076925,0.0,92.3076923076923
novadex,0,0,0,0,0.0,0.0,0.0
futureverse,0,0,0,0,0.0,0.0,0.0
script network,0,0,0,0,0.0,0.0,0.0
secret network,2,0,1,3,66.66666666666666,0.0,33.33333333333333
hydra,10,0,33,43,23.25581395348837,0.0,76.74418604651163
my lotto coin,0,0,0,0,0.0,0.0,0.0
anchor protocol,30,0,4,34,88.23529411764706,0.0,11.76470588235294
graphene,0,0,0,0,0.0,0.0,0.0
utile network,0,0,0,0,0.0,0.0,0.0
donnie finance,0,0,0,0,0.0,0.0,0.0
sperax,0,0,0,0,0.0,0.0,0.0
pooltogether,0,0,0,0,0.0,0.0,0.0
sifchain,0,0,0,0,0.0,0.0,0.0
neutrino protocol,0,0,0,0,0.0,0.0,0.0
bounce,24,0,76,100,24.0,0.0,76.0
invest & hodl,0,0,0,0,0.0,0.0,0.0
furucombo,0,0,0,0,0.0,0.0,0.0
lido,5,0,14,19,26.31578947368421,0.0,73.68421052631578
chainge,0,0,2,2,0.0,0.0,100.0
onx finance,1,0,1,2,50.0,0.0,50.0
marcopolo protocol,3,0,0,3,100.0,0.0,0.0
phala network,0,0,0,0,0.0,0.0,0.0
mirror protocol,26,0,1,27,96.29629629629629,0.0,3.7037037037037033
numio,0,0,0,0,0.0,0.0,0.0
flare,6,0,37,43,13.953488372093023,0.0,86.04651162790698
socialgood,0,0,0,0,0.0,0.0,0.0
metex,0,0,1,1,0.0,0.0,100.0
tomochain,0,0,0,0,0.0,0.0,0.0
audius,0,0,1,1,0.0,0.0,100.0
swanfinance,0,0,1,1,0.0,0.0,100.0
plutus,1,0,3,4,25.0,0.0,75.0
dia,548,0,1737,2285,23.98249452954048,0.0,76.01750547045953
permission,11,0,84,95,11.578947368421053,0.0,88.42105263157895
massnet,0,0,1,1,0.0,0.0,100.0
symbol,25,0,55,80,31.25,0.0,68.75
bitcoin rhodium,0,0,0,0,0.0,0.0,0.0
intexcoin,0,0,0,0,0.0,0.0,0.0
gooddollar,0,0,0,0,0.0,0.0,0.0
arcs,3,0,6,9,33.33333333333333,0.0,66.66666666666666
defichain,1,0,2,3,33.33333333333333,0.0,66.66666666666666
cypherium,0,0,0,0,0.0,0.0,0.0
handshake,2,0,8,10,20.0,0.0,80.0
pcash,0,0,2,2,0.0,0.0,100.0
swissborg,2,0,3,5,40.0,0.0,60.0
uniworld,0,0,0,0,0.0,0.0,0.0
babb,5,0,5,10,50.0,0.0,50.0
bitribe,0,0,0,0,0.0,0.0,0.0
nowex,0,0,0,0,0.0,0.0,0.0
dao maker,0,0,0,0,0.0,0.0,0.0
escher,5,0,30,35,14.285714285714285,0.0,85.71428571428571
bitbns,0,0,0,0,0.0,0.0,0.0
ludena protocol,0,0,0,0,0.0,0.0,0.0
pointpay,2,0,13,15,13.333333333333334,0.0,86.66666666666667
just,3188,0,10024,13212,24.129579170451105,0.0,75.87042082954889
relictum pro,0,0,0,0,0.0,0.0,0.0
storeum,0,0,4,4,0.0,0.0,100.0
stellarpayglobal,0,0,0,0,0.0,0.0,0.0
drk defi,0,0,0,0,0.0,0.0,0.0
two prime,0,0,3,3,0.0,0.0,100.0
pac global,0,0,0,0,0.0,0.0,0.0
funderone,0,0,0,0,0.0,0.0,0.0
azbi,2,0,1,3,66.66666666666666,0.0,33.33333333333333
storex,0,0,0,0,0.0,0.0,0.0
blockpass,0,0,0,0,0.0,0.0,0.0
xinfin,0,0,3,3,0.0,0.0,100.0
1xbit,0,0,0,0,0.0,0.0,0.0
vnt chain labs,0,0,0,0,0.0,0.0,0.0
icury,0,0,0,0,0.0,0.0,0.0
swapzone,0,0,0,0,0.0,0.0,0.0
tandem,1,0,5,6,16.666666666666664,0.0,83.33333333333334
jdx,5,0,4,9,55.55555555555556,0.0,44.44444444444444
global gaming,0,0,0,0,0.0,0.0,0.0
foodecent,0,0,0,0,0.0,0.0,0.0
noknok,0,0,2,2,0.0,0.0,100.0
minereum,0,0,0,0,0.0,0.0,0.0
unochain,0,0,3,3,0.0,0.0,100.0
social club rocks,0,0,0,0,0.0,0.0,0.0
kulap,13,0,7,20,65.0,0.0,35.0
petro,11,0,29,40,27.500000000000004,0.0,72.5
b one payment,0,0,1,1,0.0,0.0,100.0
personal wager,0,0,1,1,0.0,0.0,100.0
coalculus,0,0,0,0,0.0,0.0,0.0
beldex,0,0,0,0,0.0,0.0,0.0
dain,2,0,10,12,16.666666666666664,0.0,83.33333333333334
emirex,0,0,0,0,0.0,0.0,0.0
bitcoin turbo koin giveaway,0,0,0,0,0.0,0.0,0.0
bancor,3,0,12,15,20.0,0.0,80.0
jil tokens,0,0,0,0,0.0,0.0,0.0
k-tune,11,0,4,15,73.33333333333333,0.0,26.666666666666668
ecxx,0,0,0,0,0.0,0.0,0.0
pockero,0,0,2,2,0.0,0.0,100.0
netspot solutions,0,0,0,0,0.0,0.0,0.0
limestone network,4,0,1,5,80.0,0.0,20.0
p2p club,1,0,1,2,50.0,0.0,50.0
bitcollar,0,0,2,2,0.0,0.0,100.0
lino network,0,0,0,0,0.0,0.0,0.0
brave new coin,0,0,0,0,0.0,0.0,0.0
wavesbet,0,0,0,0,0.0,0.0,0.0
riwigo,2,0,1,3,66.66666666666666,0.0,33.33333333333333
liquidapps,0,0,0,0,0.0,0.0,0.0
herocoin,1,0,2,3,33.33333333333333,0.0,66.66666666666666
blocbox,2,0,2,4,50.0,0.0,50.0
morpheus network,0,0,0,0,0.0,0.0,0.0
neo smart energy,0,0,2,2,0.0,0.0,100.0
stan world,1,0,2,3,33.33333333333333,0.0,66.66666666666666
tune.fm,3,0,24,27,11.11111111111111,0.0,88.88888888888889
swiftex,1,0,0,1,100.0,0.0,0.0
diagon,0,0,0,0,0.0,0.0,0.0
refork,0,0,0,0,0.0,0.0,0.0
apollo,23,0,37,60,38.333333333333336,0.0,61.66666666666667
cryptocells,0,0,2,2,0.0,0.0,100.0
freelanex,0,0,0,0,0.0,0.0,0.0
beowulf blockchain,0,0,1,1,0.0,0.0,100.0
freedomoptions,0,0,0,0,0.0,0.0,0.0
2key,0,0,0,0,0.0,0.0,0.0
crypto tribunal,0,0,0,0,0.0,0.0,0.0
troytrade,0,0,0,0,0.0,0.0,0.0
kappi,0,0,0,0,0.0,0.0,0.0
kuvacash,0,0,0,0,0.0,0.0,0.0
enod,0,0,5,5,0.0,0.0,100.0
cudos,0,0,1,1,0.0,0.0,100.0
bitquant,0,0,0,0,0.0,0.0,0.0
binance jex,0,0,0,0,0.0,0.0,0.0
yezcoin,0,0,2,2,0.0,0.0,100.0
validity,2,0,3,5,40.0,0.0,60.0
rif,275,0,796,1071,25.67693744164332,0.0,74.32306255835668
medilives,0,0,0,0,0.0,0.0,0.0
ormeus ecosystem,0,0,0,0,0.0,0.0,0.0
inmining,5,0,9,14,35.714285714285715,0.0,64.28571428571429
nos initiative,0,0,0,0,0.0,0.0,0.0
maecenas,0,0,0,0,0.0,0.0,0.0
nova mining,0,0,0,0,0.0,0.0,0.0
project with,74,0,7,81,91.35802469135803,0.0,8.641975308641975
adrenaline ai,0,0,0,0,0.0,0.0,0.0
hydro,6,0,18,24,25.0,0.0,75.0
oilwellcoin,0,0,2,2,0.0,0.0,100.0
pynk,0,0,0,0,0.0,0.0,0.0
gcox,0,0,0,0,0.0,0.0,0.0
cocos bcx,0,0,0,0,0.0,0.0,0.0
livetree,0,0,4,4,0.0,0.0,100.0
felixo,0,0,0,0,0.0,0.0,0.0
wink,11,0,14,25,44.0,0.0,56.00000000000001
telecoin,0,0,1,1,0.0,0.0,100.0
spockchain,0,0,0,0,0.0,0.0,0.0
arena match,0,0,0,0,0.0,0.0,0.0
discodery,0,0,0,0,0.0,0.0,0.0
qtum,1,0,3,4,25.0,0.0,75.0
netkoin,2,0,2,4,50.0,0.0,50.0
algorand,17,0,47,64,26.5625,0.0,73.4375
ten billion coin,0,0,0,0,0.0,0.0,0.0
ovr,5,0,24,29,17.24137931034483,0.0,82.75862068965517
bags token,0,0,0,0,0.0,0.0,0.0
allforcrypto,0,0,0,0,0.0,0.0,0.0
civic,21,0,35,56,37.5,0.0,62.5
komodo,0,0,5,5,0.0,0.0,100.0
netbox.global,0,0,1,1,0.0,0.0,100.0
brikcoin,2,0,0,2,100.0,0.0,0.0
piexgo,2,0,9,11,18.181818181818183,0.0,81.81818181818183
paramountdax,0,0,0,0,0.0,0.0,0.0
mediacoin,1,0,0,1,100.0,0.0,0.0
dusk network,0,0,0,0,0.0,0.0,0.0
counos platform,0,0,0,0,0.0,0.0,0.0
btcow,0,0,0,0,0.0,0.0,0.0
fio social,2,0,0,2,100.0,0.0,0.0
pbet,0,0,0,0,0.0,0.0,0.0
coincome,0,0,1,1,0.0,0.0,100.0
comno network,0,0,0,0,0.0,0.0,0.0
blaze protocol,0,0,0,0,0.0,0.0,0.0
genesis,15,0,62,77,19.480519480519483,0.0,80.51948051948052
doctailor,0,0,0,0,0.0,0.0,0.0
fortem capital,1,0,0,1,100.0,0.0,0.0
authoreon,0,0,0,0,0.0,0.0,0.0
ideafex,2,0,2,4,50.0,0.0,50.0
ubrica,1,0,1,2,50.0,0.0,50.0
typerium,1,0,2,3,33.33333333333333,0.0,66.66666666666666
vcc exchange,0,0,3,3,0.0,0.0,100.0
product protocol,0,0,0,0,0.0,0.0,0.0
ethplode,0,0,0,0,0.0,0.0,0.0
sdat,0,0,11,11,0.0,0.0,100.0
sparrow,0,0,0,0,0.0,0.0,0.0
anchor,44,0,67,111,39.63963963963964,0.0,60.36036036036037
creamcoin,0,0,6,6,0.0,0.0,100.0
cindx,0,0,0,0,0.0,0.0,0.0
atlas protocol,2,0,0,2,100.0,0.0,0.0
plasmapay,0,0,0,0,0.0,0.0,0.0
raven protocol,1,0,5,6,16.666666666666664,0.0,83.33333333333334
bcnex,17,0,2,19,89.47368421052632,0.0,10.526315789473683
triffic,1,0,1,2,50.0,0.0,50.0
cotrader,0,0,0,0,0.0,0.0,0.0
mimblewimblecoin,0,0,0,0,0.0,0.0,0.0
mimidi,1,0,2,3,33.33333333333333,0.0,66.66666666666666
globatalent,0,0,0,0,0.0,0.0,0.0
xprivate chat,0,0,0,0,0.0,0.0,0.0
homebloc,2,0,1,3,66.66666666666666,0.0,33.33333333333333
xr web,0,0,0,0,0.0,0.0,0.0
suku,1,0,1,2,50.0,0.0,50.0
diamdexx,0,0,0,0,0.0,0.0,0.0
ampleforth,0,0,0,0,0.0,0.0,0.0
minglechain,0,0,4,4,0.0,0.0,100.0
bitwings,0,0,0,0,0.0,0.0,0.0
uhive,0,0,0,0,0.0,0.0,0.0
tryvium,0,0,1,1,0.0,0.0,100.0
aibb,0,0,3,3,0.0,0.0,100.0
dukascoin,0,0,5,5,0.0,0.0,100.0
sixdomainchain,0,0,0,0,0.0,0.0,0.0
crypto market ads,0,0,0,0,0.0,0.0,0.0
universalcoin,0,0,0,0,0.0,0.0,0.0
p2ps,0,0,0,0,0.0,0.0,0.0
social chains,0,0,1,1,0.0,0.0,100.0
reserve round 2,0,0,0,0,0.0,0.0,0.0
dvmarketplace,0,0,0,0,0.0,0.0,0.0
bank of hodlers,0,0,0,0,0.0,0.0,0.0
opiria,0,0,0,0,0.0,0.0,0.0
kozjin,0,0,0,0,0.0,0.0,0.0
bullex,0,0,0,0,0.0,0.0,0.0
allsesame,0,0,0,0,0.0,0.0,0.0
fesschain,0,0,0,0,0.0,0.0,0.0
dayta,0,0,0,0,0.0,0.0,0.0
mindexcoin,0,0,0,0,0.0,0.0,0.0
grayll,1,0,0,1,100.0,0.0,0.0
ferrum network,1,0,0,1,100.0,0.0,0.0
ten,1687,0,5211,6898,24.45636416352566,0.0,75.54363583647434
noia network,0,0,0,0,0.0,0.0,0.0
matrix ai network,0,0,0,0,0.0,0.0,0.0
amuse,9,0,8,17,52.94117647058824,0.0,47.05882352941176
mediconnect,0,0,0,0,0.0,0.0,0.0
bittube,0,0,1,1,0.0,0.0,100.0
authpaper,2,0,3,5,40.0,0.0,60.0
btscoin,2,0,0,2,100.0,0.0,0.0
coinhe,0,0,1,1,0.0,0.0,100.0
localcoin,0,0,0,0,0.0,0.0,0.0
stellarpay,0,0,0,0,0.0,0.0,0.0
iotw,0,0,0,0,0.0,0.0,0.0
cryptoxygen,0,0,0,0,0.0,0.0,0.0
cinemadrom,2,0,0,2,100.0,0.0,0.0
fusion coin,1,0,1,2,50.0,0.0,50.0
cbnt,0,0,1,1,0.0,0.0,100.0
odem,0,0,25,25,0.0,0.0,100.0
earthbi,0,0,3,3,0.0,0.0,100.0
venoty,0,0,2,2,0.0,0.0,100.0
futurepia,0,0,3,3,0.0,0.0,100.0
rtree,0,0,1,1,0.0,0.0,100.0
streamex,3,0,2,5,60.0,0.0,40.0
tipestry,0,0,0,0,0.0,0.0,0.0
betinance,0,0,0,0,0.0,0.0,0.0
bitforex,0,0,1,1,0.0,0.0,100.0
coinquista,0,0,0,0,0.0,0.0,0.0
amanpuri,0,0,0,0,0.0,0.0,0.0
atomic wallet,0,0,4,4,0.0,0.0,100.0
five colors coin,0,0,2,2,0.0,0.0,100.0
even foundation,0,0,0,0,0.0,0.0,0.0
konstellation,0,0,0,0,0.0,0.0,0.0
gemstra,0,0,0,0,0.0,0.0,0.0
chelle coin,1,0,0,1,100.0,0.0,0.0
pukkamex,0,0,3,3,0.0,0.0,100.0
avxchange,0,0,0,0,0.0,0.0,0.0
eden.best,0,0,0,0,0.0,0.0,0.0
licht project,0,0,1,1,0.0,0.0,100.0
trade nexi,0,0,0,0,0.0,0.0,0.0
openweb network,0,0,0,0,0.0,0.0,0.0
somesing,0,0,0,0,0.0,0.0,0.0
vite,36,0,131,167,21.55688622754491,0.0,78.44311377245509
madana,0,0,0,0,0.0,0.0,0.0
knowledge,127,0,307,434,29.262672811059907,0.0,70.73732718894009
block and chain,0,0,0,0,0.0,0.0,0.0
monarch,5,0,14,19,26.31578947368421,0.0,73.68421052631578
ally network,0,0,0,0,0.0,0.0,0.0
files.fm,1,0,0,1,100.0,0.0,0.0
terra credit,0,0,0,0,0.0,0.0,0.0
tangle,9,0,21,30,30.0,0.0,70.0
vecap,0,0,0,0,0.0,0.0,0.0
havaex,0,0,0,0,0.0,0.0,0.0
fst network,0,0,0,0,0.0,0.0,0.0
vodi x,0,0,0,0,0.0,0.0,0.0
quarkchain,0,0,1,1,0.0,0.0,100.0
purple butterfly trading,0,0,0,0,0.0,0.0,0.0
digitex,0,0,0,0,0.0,0.0,0.0
omnity,0,0,0,0,0.0,0.0,0.0
sheepcoin,0,0,4,4,0.0,0.0,100.0
quigig,2,0,3,5,40.0,0.0,60.0
uma,280,0,943,1223,22.894521668029437,0.0,77.10547833197057
vine protocol,0,0,0,0,0.0,0.0,0.0
opensea traders,0,0,0,0,0.0,0.0,0.0
mofi finance,0,0,0,0,0.0,0.0,0.0
poap,2,0,3,5,40.0,0.0,60.0
moozicore,1,0,0,1,100.0,0.0,0.0
cryptosoul,3,0,6,9,33.33333333333333,0.0,66.66666666666666
nodis,0,0,3,3,0.0,0.0,100.0
solve.care,7,0,2,9,77.77777777777779,0.0,22.22222222222222
4hiphop,2,0,0,2,100.0,0.0,0.0
almeedex,0,0,0,0,0.0,0.0,0.0
saiterm,0,0,0,0,0.0,0.0,0.0
xcoynz,0,0,0,0,0.0,0.0,0.0
btcex,0,0,0,0,0.0,0.0,0.0
vanm,1,0,2,3,33.33333333333333,0.0,66.66666666666666
hyperionx,0,0,0,0,0.0,0.0,0.0
crypto potential,0,0,0,0,0.0,0.0,0.0
wowx,3,0,2,5,60.0,0.0,40.0
triipmiles,0,0,0,0,0.0,0.0,0.0
yellowtradingcoin,1,0,0,1,100.0,0.0,0.0
bluenote,2,0,2,4,50.0,0.0,50.0
cogmento,2,0,0,2,100.0,0.0,0.0
xpchain,1,0,4,5,20.0,0.0,80.0
kronn,0,0,1,1,0.0,0.0,100.0
glad network,0,0,0,0,0.0,0.0,0.0
thevault,0,0,0,0,0.0,0.0,0.0
cointiger,0,0,0,0,0.0,0.0,0.0
precium foundation,0,0,0,0,0.0,0.0,0.0
global cryptocurrency,0,0,0,0,0.0,0.0,0.0
z-pop dream,7,0,6,13,53.84615384615385,0.0,46.15384615384615
whirl,1,0,2,3,33.33333333333333,0.0,66.66666666666666
daily coin news,0,0,0,0,0.0,0.0,0.0
bittorrent,1,0,13,14,7.142857142857142,0.0,92.85714285714286
hxro,0,0,0,0,0.0,0.0,0.0
dacc,2,0,2,4,50.0,0.0,50.0
singh,2,0,0,2,100.0,0.0,0.0
pop network,0,0,0,0,0.0,0.0,0.0
mesg,1,0,2,3,33.33333333333333,0.0,66.66666666666666
dataonblock,0,0,0,0,0.0,0.0,0.0
proof of toss,0,0,0,0,0.0,0.0,0.0
terragreen,0,0,0,0,0.0,0.0,0.0
paxpago,1,0,0,1,100.0,0.0,0.0
afincoin,0,0,0,0,0.0,0.0,0.0
the collective,6,0,14,20,30.0,0.0,70.0
lto network,0,0,1,1,0.0,0.0,100.0
insights network,0,0,0,0,0.0,0.0,0.0
cloverdex,1,0,0,1,100.0,0.0,0.0
decentrax,0,0,1,1,0.0,0.0,100.0
volentix,4,0,4,8,50.0,0.0,50.0
energi,5,0,6,11,45.45454545454545,0.0,54.54545454545454
opu labs,2,0,0,2,100.0,0.0,0.0
sharemeall,0,0,0,0,0.0,0.0,0.0
mycryptobank,0,0,0,0,0.0,0.0,0.0
grailum lab,0,0,0,0,0.0,0.0,0.0
petchains,2,0,4,6,33.33333333333333,0.0,66.66666666666666
paradise token,2,0,2,4,50.0,0.0,50.0
game fanz,0,0,0,0,0.0,0.0,0.0
konkrete,0,0,0,0,0.0,0.0,0.0
klickzie,1,0,2,3,33.33333333333333,0.0,66.66666666666666
tradeplace,0,0,1,1,0.0,0.0,100.0
ares tech,0,0,0,0,0.0,0.0,0.0
hubrisone,0,0,0,0,0.0,0.0,0.0
perkscoin,0,0,0,0,0.0,0.0,0.0
sentivate,0,0,0,0,0.0,0.0,0.0
bitcoin confidential,2,0,2,4,50.0,0.0,50.0
dragonglass,0,0,0,0,0.0,0.0,0.0
thorchain,3,0,7,10,30.0,0.0,70.0
griffex,2,0,3,5,40.0,0.0,60.0
accumulus threat shield,0,0,0,0,0.0,0.0,0.0
earnet,0,0,0,0,0.0,0.0,0.0
mobilego,0,0,0,0,0.0,0.0,0.0
hotelload,0,0,0,0,0.0,0.0,0.0
dnn,0,0,0,0,0.0,0.0,0.0
playgroundz,1,0,2,3,33.33333333333333,0.0,66.66666666666666
bitsong,1,0,3,4,25.0,0.0,75.0
omnibazaar,0,0,0,0,0.0,0.0,0.0
inmax,0,0,3,3,0.0,0.0,100.0
platon finance,0,0,0,0,0.0,0.0,0.0
idap.io,5,0,4,9,55.55555555555556,0.0,44.44444444444444
levolution,0,0,0,0,0.0,0.0,0.0
bethereum,4,0,5,9,44.44444444444444,0.0,55.55555555555556
gamb,93,0,240,333,27.927927927927925,0.0,72.07207207207207
ice chain,2,0,10,12,16.666666666666664,0.0,83.33333333333334
pareto network,0,0,0,0,0.0,0.0,0.0
solarex,0,0,0,0,0.0,0.0,0.0
spectrum,11,0,30,41,26.82926829268293,0.0,73.17073170731707
faba,2,0,4,6,33.33333333333333,0.0,66.66666666666666
indochain,0,0,0,0,0.0,0.0,0.0
liquid (raffle),0,0,0,0,0.0,0.0,0.0
vegannation,0,0,0,0,0.0,0.0,0.0
dsion,0,0,0,0,0.0,0.0,0.0
tokenville,0,0,5,5,0.0,0.0,100.0
gooreo,0,0,0,0,0.0,0.0,0.0
populstay,0,0,0,0,0.0,0.0,0.0
uris,40,0,100,140,28.57142857142857,0.0,71.42857142857143
havven,1,0,1,2,50.0,0.0,50.0
cryptobonusmiles,0,0,0,0,0.0,0.0,0.0
jarvis,0,0,0,0,0.0,0.0,0.0
bancryp,0,0,2,2,0.0,0.0,100.0
medoctor,0,0,6,6,0.0,0.0,100.0
cubego,1,0,1,2,50.0,0.0,50.0
unification,0,0,2,2,0.0,0.0,100.0
mind ai,0,0,1,1,0.0,0.0,100.0
cures token,0,0,0,0,0.0,0.0,0.0
mobile token bank,0,0,0,0,0.0,0.0,0.0
goddex,2,0,9,11,18.181818181818183,0.0,81.81818181818183
springrole,0,0,0,0,0.0,0.0,0.0
securypto,1,0,4,5,20.0,0.0,80.0
dolla,106,0,582,688,15.406976744186046,0.0,84.59302325581395
tune token,0,0,0,0,0.0,0.0,0.0
v systems,0,0,0,0,0.0,0.0,0.0
ocnet,0,0,0,0,0.0,0.0,0.0
orbise,0,0,1,1,0.0,0.0,100.0
sonata.ai,0,0,2,2,0.0,0.0,100.0
phoneum,0,0,2,2,0.0,0.0,100.0
c2c,0,0,7,7,0.0,0.0,100.0
bitcanna,0,0,0,0,0.0,0.0,0.0
smart trade coin,0,0,0,0,0.0,0.0,0.0
wellmee,20,0,3,23,86.95652173913044,0.0,13.043478260869565
varius world tech,0,0,1,1,0.0,0.0,100.0
zensports,0,0,0,0,0.0,0.0,0.0
raido,1,0,4,5,20.0,0.0,80.0
biton,0,0,0,0,0.0,0.0,0.0
tokedo,0,0,0,0,0.0,0.0,0.0
unifox,0,0,0,0,0.0,0.0,0.0
one solution,0,0,6,6,0.0,0.0,100.0
pgf500,0,0,0,0,0.0,0.0,0.0
datafund,2,0,1,3,66.66666666666666,0.0,33.33333333333333
trippki,2,0,1,3,66.66666666666666,0.0,33.33333333333333
murmur,0,0,0,0,0.0,0.0,0.0
rewards,188,0,296,484,38.84297520661157,0.0,61.15702479338842
namacoin,0,0,0,0,0.0,0.0,0.0
the 4th pillar,0,0,0,0,0.0,0.0,0.0
qubay,0,0,0,0,0.0,0.0,0.0
socialremit,4,0,5,9,44.44444444444444,0.0,55.55555555555556
allive,0,0,0,0,0.0,0.0,0.0
clear foundation,0,0,0,0,0.0,0.0,0.0
thefund.io,0,0,0,0,0.0,0.0,0.0
qobit,0,0,0,0,0.0,0.0,0.0
gamo protocol,0,0,0,0,0.0,0.0,0.0
bitozz,1,0,0,1,100.0,0.0,0.0
nd invest,33,0,37,70,47.14285714285714,0.0,52.85714285714286
gg international,0,0,0,0,0.0,0.0,0.0
tradesprite,0,0,0,0,0.0,0.0,0.0
veryfile,16,0,3,19,84.21052631578947,0.0,15.789473684210526
temco,0,0,2,2,0.0,0.0,100.0
social note,0,0,0,0,0.0,0.0,0.0
xrp by huobi,0,0,0,0,0.0,0.0,0.0
x infinity,0,0,0,0,0.0,0.0,0.0
fanchain,2,0,2,4,50.0,0.0,50.0
fidelity house,0,0,0,0,0.0,0.0,0.0
bitcademy,0,0,0,0,0.0,0.0,0.0
fiiicoin,0,0,0,0,0.0,0.0,0.0
platin,17,0,31,48,35.41666666666667,0.0,64.58333333333334
hintchain,4,0,2,6,66.66666666666666,0.0,33.33333333333333
london block exchange,0,0,0,0,0.0,0.0,0.0
phoenix,8,0,23,31,25.806451612903224,0.0,74.19354838709677
athero,0,0,1,1,0.0,0.0,100.0
bitvalve,0,0,0,0,0.0,0.0,0.0
arcc,0,0,0,0,0.0,0.0,0.0
verity,0,0,7,7,0.0,0.0,100.0
belacam,0,0,0,0,0.0,0.0,0.0
blocpal,0,0,0,0,0.0,0.0,0.0
mindsync,0,0,0,0,0.0,0.0,0.0
velic,0,0,3,3,0.0,0.0,100.0
highbank,1,0,0,1,100.0,0.0,0.0
fortfc,0,0,0,0,0.0,0.0,0.0
curveblock,2,0,2,4,50.0,0.0,50.0
huddl,0,0,0,0,0.0,0.0,0.0
feedock,0,0,0,0,0.0,0.0,0.0
hara,287,0,470,757,37.912813738441216,0.0,62.08718626155878
vreo,0,0,0,0,0.0,0.0,0.0
hilynk,0,0,2,2,0.0,0.0,100.0
depository network,0,0,0,0,0.0,0.0,0.0
ellcrys,2,0,3,5,40.0,0.0,60.0
bitpanda,0,0,10,10,0.0,0.0,100.0
consensus,26,0,82,108,24.074074074074073,0.0,75.92592592592592
stox,0,0,1,1,0.0,0.0,100.0
mycro jobs,0,0,0,0,0.0,0.0,0.0
instant sponsor,0,0,0,0,0.0,0.0,0.0
gofind.world,0,0,0,0,0.0,0.0,0.0
minedblock,0,0,0,0,0.0,0.0,0.0
crypt-on,0,0,1,1,0.0,0.0,100.0
coinjax,0,0,0,0,0.0,0.0,0.0
lexit,22,0,42,64,34.375,0.0,65.625
aivon,0,0,0,0,0.0,0.0,0.0
archetypal network,0,0,0,0,0.0,0.0,0.0
b21,2,0,12,14,14.285714285714285,0.0,85.71428571428571
open packaging network,0,0,0,0,0.0,0.0,0.0
bistox exchange,0,0,0,0,0.0,0.0,0.0
fortknoxster,0,0,1,1,0.0,0.0,100.0
connecty,0,0,0,0,0.0,0.0,0.0
truwho,0,0,1,1,0.0,0.0,100.0
hydro protocol,0,0,0,0,0.0,0.0,0.0
kidbizo,0,0,0,0,0.0,0.0,0.0
sirin labs,0,0,0,0,0.0,0.0,0.0
get achieve,2,0,6,8,25.0,0.0,75.0
bright network,1,0,3,4,25.0,0.0,75.0
sentinel,6,0,30,36,16.666666666666664,0.0,83.33333333333334
certified diamond coin,0,0,3,3,0.0,0.0,100.0
idealcoin,0,0,0,0,0.0,0.0,0.0
gozo,0,0,3,3,0.0,0.0,100.0
smart refinery technologies,0,0,0,0,0.0,0.0,0.0
javvy,0,0,0,0,0.0,0.0,0.0
stayge,0,0,0,0,0.0,0.0,0.0
zulu republic,0,0,0,0,0.0,0.0,0.0
aelf,0,0,0,0,0.0,0.0,0.0
eth birds,0,0,0,0,0.0,0.0,0.0
webloc,1,0,11,12,8.333333333333332,0.0,91.66666666666666
superbloom,0,0,0,0,0.0,0.0,0.0
rise,316,0,565,881,35.8683314415437,0.0,64.1316685584563
bitsrent,0,0,0,0,0.0,0.0,0.0
cryptocoin insurance,0,0,0,0,0.0,0.0,0.0
job.com,0,0,1,1,0.0,0.0,100.0
bionic,0,0,1,1,0.0,0.0,100.0
renaissance engineering,0,0,0,0,0.0,0.0,0.0
cubiex,0,0,0,0,0.0,0.0,0.0
qredit,0,0,4,4,0.0,0.0,100.0
digitalbits,0,0,0,0,0.0,0.0,0.0
iuno,0,0,1,1,0.0,0.0,100.0
emusic,1,0,0,1,100.0,0.0,0.0
restart energy,0,0,0,0,0.0,0.0,0.0
infinitus,3,0,2,5,60.0,0.0,40.0
lampix,0,0,0,0,0.0,0.0,0.0
magnetics,5,0,9,14,35.714285714285715,0.0,64.28571428571429
aora,0,0,0,0,0.0,0.0,0.0
sportsfix,0,0,1,1,0.0,0.0,100.0
qlear protocol,0,0,1,1,0.0,0.0,100.0
morlabs,0,0,0,0,0.0,0.0,0.0
wooshcoin,0,0,0,0,0.0,0.0,0.0
coinbates,0,0,0,0,0.0,0.0,0.0
ono,291,0,927,1218,23.891625615763548,0.0,76.10837438423646
triphop,2,0,2,4,50.0,0.0,50.0
neironix,0,0,0,0,0.0,0.0,0.0
powerchain,1,0,14,15,6.666666666666667,0.0,93.33333333333333
xenia,1,0,2,3,33.33333333333333,0.0,66.66666666666666
your data safe,0,0,0,0,0.0,0.0,0.0
pigzbe,0,0,0,0,0.0,0.0,0.0
balehu protocol,4,0,0,4,100.0,0.0,0.0
storiqa,0,0,0,0,0.0,0.0,0.0
centaure,0,0,0,0,0.0,0.0,0.0
loopring,13,0,37,50,26.0,0.0,74.0
ai crypto,0,0,0,0,0.0,0.0,0.0
spin protocol,0,0,1,1,0.0,0.0,100.0
social media pay,0,0,0,0,0.0,0.0,0.0
abbc foundation,0,0,0,0,0.0,0.0,0.0
redi,382,0,854,1236,30.906148867313917,0.0,69.09385113268608
logisticsx,0,0,1,1,0.0,0.0,100.0
fastrader,0,0,0,0,0.0,0.0,0.0
tokenbacon,0,0,2,2,0.0,0.0,100.0
suapp,0,0,0,0,0.0,0.0,0.0
districts,0,0,7,7,0.0,0.0,100.0
ecta,61,0,126,187,32.62032085561498,0.0,67.37967914438502
silent notary,0,0,0,0,0.0,0.0,0.0
centive,33,0,148,181,18.23204419889503,0.0,81.76795580110497
pingpaid,0,0,0,0,0.0,0.0,0.0
becent,0,0,1,1,0.0,0.0,100.0
xtribe,1,0,1,2,50.0,0.0,50.0
inlock,0,0,0,0,0.0,0.0,0.0
krypti,3,0,3,6,50.0,0.0,50.0
asobi coin,2,0,0,2,100.0,0.0,0.0
borneo,2,0,0,2,100.0,0.0,0.0
nerves foundation,0,0,0,0,0.0,0.0,0.0
tatau,0,0,0,0,0.0,0.0,0.0
aenco,0,0,0,0,0.0,0.0,0.0
cybervein,1,0,0,1,100.0,0.0,0.0
karatcoin,6,0,0,6,100.0,0.0,0.0
artpro,0,0,0,0,0.0,0.0,0.0
penchant,0,0,1,1,0.0,0.0,100.0
parkade,0,0,1,1,0.0,0.0,100.0
nonzero,1,0,3,4,25.0,0.0,75.0
cardonio,0,0,0,0,0.0,0.0,0.0
sansox,0,0,0,0,0.0,0.0,0.0
swachhcoin,0,0,0,0,0.0,0.0,0.0
shopin,0,0,0,0,0.0,0.0,0.0
blockkonnect,0,0,0,0,0.0,0.0,0.0
dclinic,5,0,1,6,83.33333333333334,0.0,16.666666666666664
x-cash,13,0,10,23,56.52173913043478,0.0,43.47826086956522
vibeo,0,0,1,1,0.0,0.0,100.0
masternode invest,0,0,0,0,0.0,0.0,0.0
topex,1,0,1,2,50.0,0.0,50.0
berminal,0,0,0,0,0.0,0.0,0.0
expanse,3,0,2,5,60.0,0.0,40.0
osmium investment coin,0,0,0,0,0.0,0.0,0.0
aura,44,0,70,114,38.59649122807017,0.0,61.40350877192983
wmpro,0,0,1,1,0.0,0.0,100.0
securix,0,0,0,0,0.0,0.0,0.0
udap,0,0,1,1,0.0,0.0,100.0
olife,0,0,5,5,0.0,0.0,100.0
curaizon,2,0,0,2,100.0,0.0,0.0
odin,41,0,91,132,31.060606060606062,0.0,68.93939393939394
contents protocol,1,0,0,1,100.0,0.0,0.0
beverage cash,0,0,0,0,0.0,0.0,0.0
xmax,0,0,0,0,0.0,0.0,0.0
scienceroot,1,0,0,1,100.0,0.0,0.0
spheroid universe,3,0,1,4,75.0,0.0,25.0
x-block,14,0,2,16,87.5,0.0,12.5
buying,166,0,596,762,21.784776902887142,0.0,78.21522309711287
one game,6,0,11,17,35.294117647058826,0.0,64.70588235294117
wom token,1,0,1,2,50.0,0.0,50.0
caspian,0,0,0,0,0.0,0.0,0.0
ilink2music,1,0,0,1,100.0,0.0,0.0
natmin pure escrow,3,0,0,3,100.0,0.0,0.0
kineticex,0,0,0,0,0.0,0.0,0.0
zwoop,0,0,0,0,0.0,0.0,0.0
indx capital,0,0,0,0,0.0,0.0,0.0
payx,0,0,0,0,0.0,0.0,0.0
skynet,2,0,24,26,7.6923076923076925,0.0,92.3076923076923
loveblock,0,0,0,0,0.0,0.0,0.0
ttc protocol,0,0,0,0,0.0,0.0,0.0
bithereum,0,0,0,0,0.0,0.0,0.0
moac,0,0,0,0,0.0,0.0,0.0
bitfam,0,0,0,0,0.0,0.0,0.0
republia,0,0,0,0,0.0,0.0,0.0
funkeypay,0,0,0,0,0.0,0.0,0.0
papusha,0,0,1,1,0.0,0.0,100.0
itrue,1,0,10,11,9.090909090909092,0.0,90.9090909090909
beam,8,0,18,26,30.76923076923077,0.0,69.23076923076923
kimex,2,0,2,4,50.0,0.0,50.0
twogap,0,0,0,0,0.0,0.0,0.0
lattice80,0,0,0,0,0.0,0.0,0.0
florafic,0,0,0,0,0.0,0.0,0.0
bitmart,0,0,1,1,0.0,0.0,100.0
efforce,0,0,0,0,0.0,0.0,0.0
spiking,2,0,7,9,22.22222222222222,0.0,77.77777777777779
bidooh,3,0,6,9,33.33333333333333,0.0,66.66666666666666
imusify,1,0,1,2,50.0,0.0,50.0
icovo,0,0,2,2,0.0,0.0,100.0
cloudbric,3,0,8,11,27.27272727272727,0.0,72.72727272727273
tachain,1,0,1,2,50.0,0.0,50.0
workchain,0,0,0,0,0.0,0.0,0.0
brokernekonetwork,0,0,0,0,0.0,0.0,0.0
subaj,0,0,4,4,0.0,0.0,100.0
scanetchain,0,0,0,0,0.0,0.0,0.0
payperblock,1,0,0,1,100.0,0.0,0.0
greenlink,2,0,5,7,28.57142857142857,0.0,71.42857142857143
55 exchange,0,0,0,0,0.0,0.0,0.0
finnoq,1,0,0,1,100.0,0.0,0.0
platio,1,0,3,4,25.0,0.0,75.0
dx.exchange,2,0,1,3,66.66666666666666,0.0,33.33333333333333
bcoin,1,0,2,3,33.33333333333333,0.0,66.66666666666666
skrumble network,1,0,1,2,50.0,0.0,50.0
etherinc,0,0,0,0,0.0,0.0,0.0
myos,0,0,0,0,0.0,0.0,0.0
eurekapro,0,0,0,0,0.0,0.0,0.0
avatara,1,0,1,2,50.0,0.0,50.0
odyssey,1,0,6,7,14.285714285714285,0.0,85.71428571428571
rate3,0,0,0,0,0.0,0.0,0.0
bouncy coin,0,0,0,0,0.0,0.0,0.0
agentmile,0,0,0,0,0.0,0.0,0.0
hirefreehands,3,0,7,10,30.0,0.0,70.0
denarii cash,0,0,0,0,0.0,0.0,0.0
webdollar,0,0,0,0,0.0,0.0,0.0
webuy,1,0,9,10,10.0,0.0,90.0
meca coin,0,0,3,3,0.0,0.0,100.0
abele group,0,0,0,0,0.0,0.0,0.0
agate,7,0,19,26,26.923076923076923,0.0,73.07692307692307
kronos token,0,0,0,0,0.0,0.0,0.0
wandx,1,0,16,17,5.88235294117647,0.0,94.11764705882352
envoy,0,0,0,0,0.0,0.0,0.0
iride,1,0,0,1,100.0,0.0,0.0
synthetics ai,6,0,0,6,100.0,0.0,0.0
symphony,0,0,0,0,0.0,0.0,0.0
margin,21,0,137,158,13.291139240506327,0.0,86.70886075949366
gsc aviation,0,0,0,0,0.0,0.0,0.0
share internet data,0,0,0,0,0.0,0.0,0.0
metahash,0,0,0,0,0.0,0.0,0.0
hyperquant,0,0,0,0,0.0,0.0,0.0
kheper,4,0,0,4,100.0,0.0,0.0
opporty,0,0,0,0,0.0,0.0,0.0
blackbox foundation,0,0,0,0,0.0,0.0,0.0
medchain,0,0,2,2,0.0,0.0,100.0
viddo,0,0,0,0,0.0,0.0,0.0
greenhashes,0,0,0,0,0.0,0.0,0.0
pearl pay,0,0,0,0,0.0,0.0,0.0
high performance blockchain,0,0,0,0,0.0,0.0,0.0
conference coin,0,0,0,0,0.0,0.0,0.0
yondocoin,0,0,0,0,0.0,0.0,0.0
kvantor,0,0,2,2,0.0,0.0,100.0
jupiter chain,0,0,0,0,0.0,0.0,0.0
zerostate,0,0,0,0,0.0,0.0,0.0
mapcoin,6,0,1,7,85.71428571428571,0.0,14.285714285714285
eyeglob.net,4,0,1,5,80.0,0.0,20.0
crypviser,0,0,3,3,0.0,0.0,100.0
marachain,0,0,0,0,0.0,0.0,0.0
nextpakk,4,0,1,5,80.0,0.0,20.0
distributed blocks,0,0,1,1,0.0,0.0,100.0
fieldcoin,0,0,1,1,0.0,0.0,100.0
veiag,6,0,2,8,75.0,0.0,25.0
locktrip,0,0,0,0,0.0,0.0,0.0
zinc,2,0,10,12,16.666666666666664,0.0,83.33333333333334
spl.yt,5,0,0,5,100.0,0.0,0.0
silkchain,1,0,1,2,50.0,0.0,50.0
unitalent,0,0,0,0,0.0,0.0,0.0
careerchain,0,0,0,0,0.0,0.0,0.0
craftr,0,0,0,0,0.0,0.0,0.0
thingschain,0,0,0,0,0.0,0.0,0.0
hashgard,0,0,0,0,0.0,0.0,0.0
daviescoin,0,0,0,0,0.0,0.0,0.0
contractium,0,0,0,0,0.0,0.0,0.0
mobu,1,0,2,3,33.33333333333333,0.0,66.66666666666666
philanthor,0,0,0,0,0.0,0.0,0.0
medipedia,0,0,0,0,0.0,0.0,0.0
tlpac,15,0,0,15,100.0,0.0,0.0
sports ledger,0,0,0,0,0.0,0.0,0.0
real estate doc,1,0,0,1,100.0,0.0,0.0
careonchain,0,0,0,0,0.0,0.0,0.0
project h,44,0,10,54,81.48148148148148,0.0,18.51851851851852
dream & indorse,0,0,0,0,0.0,0.0,0.0
buratinobs,0,0,0,0,0.0,0.0,0.0
openbrix,0,0,0,0,0.0,0.0,0.0
vu token,0,0,0,0,0.0,0.0,0.0
boliecoin,1,0,0,1,100.0,0.0,0.0
campuscoin,0,0,0,0,0.0,0.0,0.0
ripaex,1,0,1,2,50.0,0.0,50.0
blockvest,0,0,0,0,0.0,0.0,0.0
neoplace,0,0,0,0,0.0,0.0,0.0
intro,99,0,786,885,11.186440677966102,0.0,88.8135593220339
gstar ecosystem,1,0,1,2,50.0,0.0,50.0
everipedia,0,0,1,1,0.0,0.0,100.0
zerobank,2,0,0,2,100.0,0.0,0.0
vidy,0,0,0,0,0.0,0.0,0.0
attrace,0,0,0,0,0.0,0.0,0.0
svper,2,0,2,4,50.0,0.0,50.0
rockercoin,0,0,0,0,0.0,0.0,0.0
rays network,0,0,0,0,0.0,0.0,0.0
tokenize,4,0,12,16,25.0,0.0,75.0
dream real,0,0,2,2,0.0,0.0,100.0
asian develop coin,0,0,0,0,0.0,0.0,0.0
airstayz,0,0,1,1,0.0,0.0,100.0
yinc,0,0,3,3,0.0,0.0,100.0
bloxia,0,0,1,1,0.0,0.0,100.0
color,169,0,202,371,45.55256064690027,0.0,54.44743935309974
watermelonblock,0,0,0,0,0.0,0.0,0.0
hurtle coin,2,0,0,2,100.0,0.0,0.0
bigbang,7,0,8,15,46.666666666666664,0.0,53.333333333333336
starflow,0,0,1,1,0.0,0.0,100.0
mytc,0,0,0,0,0.0,0.0,0.0
aniko,4,0,7,11,36.36363636363637,0.0,63.63636363636363
w green pay,1,0,1,2,50.0,0.0,50.0
guarium,1,0,0,1,100.0,0.0,0.0
prime shipping foundation,0,0,0,0,0.0,0.0,0.0
propy,1,0,8,9,11.11111111111111,0.0,88.88888888888889
easy trading platform,0,0,0,0,0.0,0.0,0.0
dnet,8,0,6,14,57.14285714285714,0.0,42.857142857142854
meritt protocol,0,0,0,0,0.0,0.0,0.0
star bit,0,0,0,0,0.0,0.0,0.0
multra,1,0,4,5,20.0,0.0,80.0
expercoin,0,0,0,0,0.0,0.0,0.0
kava,2,0,13,15,13.333333333333334,0.0,86.66666666666667
bytemine,0,0,1,1,0.0,0.0,100.0
unico,13,0,22,35,37.142857142857146,0.0,62.857142857142854
diro,0,0,0,0,0.0,0.0,0.0
gratzio,0,0,0,0,0.0,0.0,0.0
bixtrim,0,0,1,1,0.0,0.0,100.0
inmediate,0,0,0,0,0.0,0.0,0.0
jsecoin,0,0,0,0,0.0,0.0,0.0
medilot,0,0,0,0,0.0,0.0,0.0
pchain,2,0,6,8,25.0,0.0,75.0
helix orange,0,0,1,1,0.0,0.0,100.0
shipit,0,0,0,0,0.0,0.0,0.0
miracle tele,2,0,0,2,100.0,0.0,0.0
runs,49,0,159,208,23.557692307692307,0.0,76.4423076923077
ignite,10,0,13,23,43.47826086956522,0.0,56.52173913043478
elyqd,0,0,0,0,0.0,0.0,0.0
bailsman,0,0,0,0,0.0,0.0,0.0
lambda,0,0,4,4,0.0,0.0,100.0
rubius,1,0,7,8,12.5,0.0,87.5
svandis,3,0,0,3,100.0,0.0,0.0
allsporter,0,0,0,0,0.0,0.0,0.0
playrs,0,0,0,0,0.0,0.0,0.0
coinanalyst,0,0,0,0,0.0,0.0,0.0
spokkz,9,0,3,12,75.0,0.0,25.0
zantepay,0,0,0,0,0.0,0.0,0.0
cure cosplay,1,0,1,2,50.0,0.0,50.0
wab network,0,0,0,0,0.0,0.0,0.0
liquid8,2,0,4,6,33.33333333333333,0.0,66.66666666666666
fanship,0,0,0,0,0.0,0.0,0.0
inmusik,3,0,1,4,75.0,0.0,25.0
crowdtoken,0,0,0,0,0.0,0.0,0.0
osa,55,0,246,301,18.272425249169437,0.0,81.72757475083057
moolyacoin,0,0,3,3,0.0,0.0,100.0
hyperbridge,0,0,1,1,0.0,0.0,100.0
tombcare,0,0,0,0,0.0,0.0,0.0
tuurnt,0,0,0,0,0.0,0.0,0.0
usechain,0,0,0,0,0.0,0.0,0.0
storeplex,0,0,0,0,0.0,0.0,0.0
parcelx,2,0,0,2,100.0,0.0,0.0
apres,8,0,16,24,33.33333333333333,0.0,66.66666666666666
blockhive,0,0,0,0,0.0,0.0,0.0
creatanium,0,0,0,0,0.0,0.0,0.0
traderiser,0,0,0,0,0.0,0.0,0.0
redcab,0,0,0,0,0.0,0.0,0.0
monopoly,11,0,66,77,14.285714285714285,0.0,85.71428571428571
sharevest,0,0,0,0,0.0,0.0,0.0
explorio,0,0,0,0,0.0,0.0,0.0
epiphany,2,0,0,2,100.0,0.0,0.0
bumo,0,0,0,0,0.0,0.0,0.0
barrel,4,0,24,28,14.285714285714285,0.0,85.71428571428571
cryptomillionslotto,0,0,0,0,0.0,0.0,0.0
immvrse,1,0,1,2,50.0,0.0,50.0
atidium,0,0,0,0,0.0,0.0,0.0
dto,7,0,9,16,43.75,0.0,56.25
provoco,0,0,3,3,0.0,0.0,100.0
traxion,0,0,0,0,0.0,0.0,0.0
bitesprit,0,0,0,0,0.0,0.0,0.0
heroic.com,0,0,0,0,0.0,0.0,0.0
dench music,0,0,0,0,0.0,0.0,0.0
versara trade,0,0,0,0,0.0,0.0,0.0
miboodle,0,0,0,0,0.0,0.0,0.0
hellogold,0,0,0,0,0.0,0.0,0.0
odmcoin,0,0,0,0,0.0,0.0,0.0
waves,10,0,29,39,25.64102564102564,0.0,74.35897435897436
mevu,0,0,0,0,0.0,0.0,0.0
casper api,0,0,0,0,0.0,0.0,0.0
lition,2,0,10,12,16.666666666666664,0.0,83.33333333333334
scidex,6,0,1,7,85.71428571428571,0.0,14.285714285714285
betform,0,0,0,0,0.0,0.0,0.0
yanu,4,0,7,11,36.36363636363637,0.0,63.63636363636363
little phil,2,0,2,4,50.0,0.0,50.0
monoreto,1,0,0,1,100.0,0.0,0.0
grapevine world,0,0,0,0,0.0,0.0,0.0
blockonomics,0,0,0,0,0.0,0.0,0.0
nauticus,0,0,0,0,0.0,0.0,0.0
further network,0,0,0,0,0.0,0.0,0.0
breezecoin,1,0,1,2,50.0,0.0,50.0
racoin,0,0,1,1,0.0,0.0,100.0
tresaro,0,0,0,0,0.0,0.0,0.0
wemark,0,0,0,0,0.0,0.0,0.0
setteo,0,0,2,2,0.0,0.0,100.0
ern,1018,0,3963,4981,20.43766311985545,0.0,79.56233688014454
terawatt,0,0,0,0,0.0,0.0,0.0
cryptovationx,0,0,0,0,0.0,0.0,0.0
feedchain,5,0,0,5,100.0,0.0,0.0
basis neuro,0,0,0,0,0.0,0.0,0.0
staramba,0,0,3,3,0.0,0.0,100.0
re:factor,8,0,0,8,100.0,0.0,0.0
greenx,1,0,3,4,25.0,0.0,75.0
ftw,64,0,279,343,18.658892128279884,0.0,81.34110787172013
atlantis blue,0,0,0,0,0.0,0.0,0.0
parkres,0,0,0,0,0.0,0.0,0.0
lendsbay,0,0,0,0,0.0,0.0,0.0
0xcert,0,0,0,0,0.0,0.0,0.0
humanscape,0,0,0,0,0.0,0.0,0.0
crowdif,0,0,0,0,0.0,0.0,0.0
videocoin,6,0,1,7,85.71428571428571,0.0,14.285714285714285
nebula,12,0,13,25,48.0,0.0,52.0
neonameservice,0,0,1,1,0.0,0.0,100.0
sparkster,0,0,0,0,0.0,0.0,0.0
buddy,69,0,83,152,45.39473684210527,0.0,54.60526315789473
crypstock,0,0,0,0,0.0,0.0,0.0
luvdub,5,0,2,7,71.42857142857143,0.0,28.57142857142857
aworker,0,0,0,0,0.0,0.0,0.0
qlc chain,0,0,0,0,0.0,0.0,0.0
sponsy,0,0,0,0,0.0,0.0,0.0
menlo one,0,0,0,0,0.0,0.0,0.0
wesend,0,0,0,0,0.0,0.0,0.0
inscoin,16,0,7,23,69.56521739130434,0.0,30.434782608695656
extrade,0,0,3,3,0.0,0.0,100.0
muxe,0,0,0,0,0.0,0.0,0.0
lina,17,0,34,51,33.33333333333333,0.0,66.66666666666666
zoidcoin,0,0,1,1,0.0,0.0,100.0
origin sport,0,0,0,0,0.0,0.0,0.0
no bs crypto,0,0,4,4,0.0,0.0,100.0
cosmecoin,0,0,1,1,0.0,0.0,100.0
railz,0,0,0,0,0.0,0.0,0.0
contentbox,13,0,5,18,72.22222222222221,0.0,27.77777777777778
rloop,0,0,0,0,0.0,0.0,0.0
bitney,1,0,1,2,50.0,0.0,50.0
apis,35,0,72,107,32.71028037383177,0.0,67.28971962616822
xmed chain,0,0,0,0,0.0,0.0,0.0
indicoin,0,0,0,0,0.0,0.0,0.0
nobar,0,0,0,0,0.0,0.0,0.0
coinself,0,0,1,1,0.0,0.0,100.0
makeafolio,0,0,0,0,0.0,0.0,0.0
iris.ai,0,0,1,1,0.0,0.0,100.0
deedcoin,0,0,0,0,0.0,0.0,0.0
dav,38,0,97,135,28.14814814814815,0.0,71.85185185185186
find.exchange,2,0,6,8,25.0,0.0,75.0
ingot coin,2,0,0,2,100.0,0.0,0.0
profede,0,0,0,0,0.0,0.0,0.0
box 2 table,0,0,0,0,0.0,0.0,0.0
globecas,0,0,0,0,0.0,0.0,0.0
goeureka,0,0,0,0,0.0,0.0,0.0
xeeda,0,0,0,0,0.0,0.0,0.0
recordskeeper,0,0,0,0,0.0,0.0,0.0
datavlt,2,0,0,2,100.0,0.0,0.0
jibbit,2,0,9,11,18.181818181818183,0.0,81.81818181818183
loyakk,0,0,0,0,0.0,0.0,0.0
avinoc,1,0,12,13,7.6923076923076925,0.0,92.3076923076923
tokenunion,0,0,0,0,0.0,0.0,0.0
root blockchain,0,0,0,0,0.0,0.0,0.0
ormeus coin,0,0,0,0,0.0,0.0,0.0
cryptoriya,0,0,0,0,0.0,0.0,0.0
mjolnir guard,0,0,0,0,0.0,0.0,0.0
daox,0,0,0,0,0.0,0.0,0.0
pavocoin,0,0,2,2,0.0,0.0,100.0
brainmab,0,0,0,0,0.0,0.0,0.0
viewo,0,0,0,0,0.0,0.0,0.0
fanfare,2,0,0,2,100.0,0.0,0.0
crystals,16,0,29,45,35.55555555555556,0.0,64.44444444444444
xgenomics,0,0,0,0,0.0,0.0,0.0
gese,1,0,9,10,10.0,0.0,90.0
askfm 2.0,0,0,0,0,0.0,0.0,0.0
b2bx,0,0,0,0,0.0,0.0,0.0
lamoneda,0,0,0,0,0.0,0.0,0.0
accounting blockchain,0,0,0,0,0.0,0.0,0.0
energi token,0,0,0,0,0.0,0.0,0.0
nebeus,0,0,0,0,0.0,0.0,0.0
iregmed,0,0,0,0,0.0,0.0,0.0
paygine,0,0,0,0,0.0,0.0,0.0
ivy,5,0,14,19,26.31578947368421,0.0,73.68421052631578
binex.trade,7,0,4,11,63.63636363636363,0.0,36.36363636363637
selfie go,0,0,0,0,0.0,0.0,0.0
clash & go,3,0,0,3,100.0,0.0,0.0
miner edge,5,0,0,5,100.0,0.0,0.0
keplertek,0,0,0,0,0.0,0.0,0.0
ink,2358,0,7566,9924,23.760580411124547,0.0,76.23941958887545
kimera,8,0,13,21,38.095238095238095,0.0,61.904761904761905
prime ball,0,0,1,1,0.0,0.0,100.0
aitheon,0,0,0,0,0.0,0.0,0.0
tatatu,0,0,0,0,0.0,0.0,0.0
supporter,25,0,46,71,35.2112676056338,0.0,64.7887323943662
neodium network,0,0,0,0,0.0,0.0,0.0
acudeen,0,0,0,0,0.0,0.0,0.0
easyloot,0,0,0,0,0.0,0.0,0.0
vimana,4,0,2,6,66.66666666666666,0.0,33.33333333333333
denet,0,0,0,0,0.0,0.0,0.0
goldma,3,0,6,9,33.33333333333333,0.0,66.66666666666666
ommer,46,0,120,166,27.710843373493976,0.0,72.28915662650603
viva network,0,0,0,0,0.0,0.0,0.0
leadrex,1,0,4,5,20.0,0.0,80.0
po8,0,0,0,0,0.0,0.0,0.0
smartmesh,0,0,0,0,0.0,0.0,0.0
atn,16,0,51,67,23.88059701492537,0.0,76.11940298507463
luna,78,0,198,276,28.26086956521739,0.0,71.73913043478261
fenix,1,0,1,2,50.0,0.0,50.0
successlife,0,0,0,0,0.0,0.0,0.0
planport,0,0,0,0,0.0,0.0,0.0
datecoin,0,0,0,0,0.0,0.0,0.0
archicoin,0,0,0,0,0.0,0.0,0.0
cryptohit,0,0,0,0,0.0,0.0,0.0
jiojiome,0,0,0,0,0.0,0.0,0.0
genexi,2,0,7,9,22.22222222222222,0.0,77.77777777777779
mcoin,2,0,11,13,15.384615384615385,0.0,84.61538461538461
conda,12,0,61,73,16.43835616438356,0.0,83.56164383561644
koumei,2,0,1,3,66.66666666666666,0.0,33.33333333333333
hodlit network,0,0,0,0,0.0,0.0,0.0
skyfchain,1,0,1,2,50.0,0.0,50.0
coinyspace,0,0,1,1,0.0,0.0,100.0
fructus,0,0,0,0,0.0,0.0,0.0
horizon,23,0,32,55,41.81818181818181,0.0,58.18181818181818
kanadecoin,0,0,0,0,0.0,0.0,0.0
xriba,0,0,0,0,0.0,0.0,0.0
towerbee,0,0,0,0,0.0,0.0,0.0
mst,30,0,141,171,17.543859649122805,0.0,82.45614035087719
etherc,0,0,1,1,0.0,0.0,100.0
elepig,0,0,2,2,0.0,0.0,100.0
dino,11,0,30,41,26.82926829268293,0.0,73.17073170731707
laborcrypto,0,0,0,0,0.0,0.0,0.0
md tokens,0,0,0,0,0.0,0.0,0.0
bitimage,0,0,0,0,0.0,0.0,0.0
byteball,0,0,0,0,0.0,0.0,0.0
grabameal,0,0,1,1,0.0,0.0,100.0
gledos,1,0,0,1,100.0,0.0,0.0
carlive chain,0,0,0,0,0.0,0.0,0.0
wono,0,0,1,1,0.0,0.0,100.0
selfsell,0,0,0,0,0.0,0.0,0.0
acute coin,0,0,2,2,0.0,0.0,100.0
cryptoflix,0,0,2,2,0.0,0.0,100.0
hubtoken,0,0,0,0,0.0,0.0,0.0
ico pass,0,0,0,0,0.0,0.0,0.0
amicorum live,0,0,0,0,0.0,0.0,0.0
global reit,0,0,2,2,0.0,0.0,100.0
wizebit,0,0,0,0,0.0,0.0,0.0
zichain,2,0,2,4,50.0,0.0,50.0
tradingene,0,0,1,1,0.0,0.0,100.0
okeydokey,0,0,0,0,0.0,0.0,0.0
birdchain,4,0,3,7,57.14285714285714,0.0,42.857142857142854
freelancercoin,0,0,0,0,0.0,0.0,0.0
blue whale,3,0,14,17,17.647058823529413,0.0,82.35294117647058
goldmint,0,0,0,0,0.0,0.0,0.0
evolutionos,1,0,4,5,20.0,0.0,80.0
linfinity,1,0,3,4,25.0,0.0,75.0
cortex,0,0,4,4,0.0,0.0,100.0
crowd for angels,2,0,0,2,100.0,0.0,0.0
iconiq lab,5,0,1,6,83.33333333333334,0.0,16.666666666666664
arousal,1,0,2,3,33.33333333333333,0.0,66.66666666666666
cgcx,2,0,0,2,100.0,0.0,0.0
wulet,0,0,0,0,0.0,0.0,0.0
elysian,0,0,0,0,0.0,0.0,0.0
coinet,0,0,1,1,0.0,0.0,100.0
lancer network,0,0,0,0,0.0,0.0,0.0
safe haven,1,0,5,6,16.666666666666664,0.0,83.33333333333334
araw token,2,0,2,4,50.0,0.0,50.0
directhome,0,0,0,0,0.0,0.0,0.0
buzcoin,1,0,0,1,100.0,0.0,0.0
dicegame,0,0,0,0,0.0,0.0,0.0
beepbeep nation,1,0,0,1,100.0,0.0,0.0
abcc exchange,0,0,0,0,0.0,0.0,0.0
deconet,0,0,0,0,0.0,0.0,0.0
datablockchain,0,0,0,0,0.0,0.0,0.0
carblock,0,0,0,0,0.0,0.0,0.0
bulleon,0,0,0,0,0.0,0.0,0.0
coincrowd,0,0,0,0,0.0,0.0,0.0
rankingball,3,0,0,3,100.0,0.0,0.0
bubbletone,2,0,2,4,50.0,0.0,50.0
mpcx,0,0,0,0,0.0,0.0,0.0
blockstorage,0,0,0,0,0.0,0.0,0.0
xceltoken plus,0,0,0,0,0.0,0.0,0.0
xchng,0,0,0,0,0.0,0.0,0.0
trustlogics,0,0,0,0,0.0,0.0,0.0
bitrent,0,0,0,0,0.0,0.0,0.0
free market token,0,0,2,2,0.0,0.0,100.0
starchain,0,0,4,4,0.0,0.0,100.0
abitchain,0,0,0,0,0.0,0.0,0.0
check-car,0,0,0,0,0.0,0.0,0.0
ai gaming,0,0,0,0,0.0,0.0,0.0
abacasxchange,0,0,1,1,0.0,0.0,100.0
ether joy,0,0,0,0,0.0,0.0,0.0
blockport,0,0,0,0,0.0,0.0,0.0
concertvr,0,0,0,0,0.0,0.0,0.0
bitminutes,0,0,0,0,0.0,0.0,0.0
bfex,0,0,1,1,0.0,0.0,100.0
hangry animals,2,0,0,2,100.0,0.0,0.0
argent,11,0,59,70,15.714285714285714,0.0,84.28571428571429
limocoinswap,0,0,0,0,0.0,0.0,0.0
socean,0,0,0,0,0.0,0.0,0.0
cfun,0,0,0,0,0.0,0.0,0.0
coin governance system,0,0,0,0,0.0,0.0,0.0
cryde,7,0,1,8,87.5,0.0,12.5
belotto,2,0,0,2,100.0,0.0,0.0
terra virtua,0,0,0,0,0.0,0.0,0.0
olympus labs,2,0,4,6,33.33333333333333,0.0,66.66666666666666
proton,6,0,19,25,24.0,0.0,76.0
touch. social network,0,0,0,0,0.0,0.0,0.0
zeex,0,0,0,0,0.0,0.0,0.0
autobay,0,0,0,0,0.0,0.0,0.0
cargochain,0,0,1,1,0.0,0.0,100.0
4new,0,0,0,0,0.0,0.0,0.0
moveco,0,0,1,1,0.0,0.0,100.0
gladage,0,0,0,0,0.0,0.0,0.0
indorse,0,0,0,0,0.0,0.0,0.0
unboxed,0,0,2,2,0.0,0.0,100.0
metamorph,1,0,4,5,20.0,0.0,80.0
delicia,0,0,5,5,0.0,0.0,100.0
0chain,0,0,0,0,0.0,0.0,0.0
esports chain,0,0,0,0,0.0,0.0,0.0
smart trip platform,0,0,0,0,0.0,0.0,0.0
trustnote,0,0,0,0,0.0,0.0,0.0
parsec frontiers,0,0,0,0,0.0,0.0,0.0
mine coin,0,0,0,0,0.0,0.0,0.0
bitrust,0,0,0,0,0.0,0.0,0.0
deeptoken,0,0,0,0,0.0,0.0,0.0
workcoin,1,0,2,3,33.33333333333333,0.0,66.66666666666666
mcfly,0,0,0,0,0.0,0.0,0.0
coinmetro,0,0,0,0,0.0,0.0,0.0
kryptono exchange,0,0,0,0,0.0,0.0,0.0
dapp builder,0,0,0,0,0.0,0.0,0.0
prevue,2,0,8,10,20.0,0.0,80.0
ethichub twitter,0,0,0,0,0.0,0.0,0.0
urbit,2,0,7,9,22.22222222222222,0.0,77.77777777777779
boosto,1,0,0,1,100.0,0.0,0.0
assettoken,0,0,2,2,0.0,0.0,100.0
anything app,1,0,0,1,100.0,0.0,0.0
pointium,2,0,0,2,100.0,0.0,0.0
biok,1,0,0,1,100.0,0.0,0.0
bitmillex,0,0,0,0,0.0,0.0,0.0
bidipass,0,0,0,0,0.0,0.0,0.0
sentinel protocol,0,0,7,7,0.0,0.0,100.0
moneytoken,0,0,0,0,0.0,0.0,0.0
bitsum,0,0,1,1,0.0,0.0,100.0
endorsit,1,0,1,2,50.0,0.0,50.0
sdchain,1,0,1,2,50.0,0.0,50.0
mingo,12,0,32,44,27.27272727272727,0.0,72.72727272727273
libertylance,0,0,0,0,0.0,0.0,0.0
block broker,0,0,0,0,0.0,0.0,0.0
hyperion,0,0,0,0,0.0,0.0,0.0
golden currency,0,0,0,0,0.0,0.0,0.0
digipulse,0,0,0,0,0.0,0.0,0.0
exchain,2,0,4,6,33.33333333333333,0.0,66.66666666666666
spindle,6,0,23,29,20.689655172413794,0.0,79.3103448275862
seda,14,0,18,32,43.75,0.0,56.25
vivalid,2,0,0,2,100.0,0.0,0.0
mbys,0,0,5,5,0.0,0.0,100.0
xenchain,0,0,0,0,0.0,0.0,0.0
kakushin,0,0,0,0,0.0,0.0,0.0
evo,269,0,414,683,39.38506588579795,0.0,60.61493411420204
strykz,0,0,0,0,0.0,0.0,0.0
kelta,2,0,7,9,22.22222222222222,0.0,77.77777777777779
rawg,3,0,8,11,27.27272727272727,0.0,72.72727272727273
aict,4,0,16,20,20.0,0.0,80.0
meshbox,1,0,4,5,20.0,0.0,80.0
eosdac,0,0,2,2,0.0,0.0,100.0
eatmecoin,0,0,0,0,0.0,0.0,0.0
superset,7,0,21,28,25.0,0.0,75.0
coinpaws,0,0,3,3,0.0,0.0,100.0
trident group,0,0,0,0,0.0,0.0,0.0
prontapay,0,0,0,0,0.0,0.0,0.0
akaiito,0,0,0,0,0.0,0.0,0.0
smarto,1,0,7,8,12.5,0.0,87.5
entry,52,0,120,172,30.23255813953488,0.0,69.76744186046511
digitize,8,0,4,12,66.66666666666666,0.0,33.33333333333333
vinchain,0,0,0,0,0.0,0.0,0.0
bit.game,2,0,5,7,28.57142857142857,0.0,71.42857142857143
pecunio,0,0,0,0,0.0,0.0,0.0
labstart,0,0,0,0,0.0,0.0,0.0
vexanium,0,0,0,0,0.0,0.0,0.0
qryptos exchange,0,0,0,0,0.0,0.0,0.0
thekey,2,0,3,5,40.0,0.0,60.0
echolink,6,0,13,19,31.57894736842105,0.0,68.42105263157895
ethichub,0,0,0,0,0.0,0.0,0.0
marginless,0,0,0,0,0.0,0.0,0.0
able,1809,0,4820,6629,27.289183888972694,0.0,72.7108161110273
cosmochain,4,0,5,9,44.44444444444444,0.0,55.55555555555556
chronobank,0,0,0,0,0.0,0.0,0.0
bitrewards,0,0,0,0,0.0,0.0,0.0
vanig,0,0,0,0,0.0,0.0,0.0
london football exchange,0,0,0,0,0.0,0.0,0.0
lemochain,0,0,0,0,0.0,0.0,0.0
surrus,0,0,3,3,0.0,0.0,100.0
cprop,2,0,2,4,50.0,0.0,50.0
bundle,5,0,40,45,11.11111111111111,0.0,88.88888888888889
3des,0,0,19,19,0.0,0.0,100.0
contract vault,0,0,0,0,0.0,0.0,0.0
modex,0,0,0,0,0.0,0.0,0.0
modorr,2,0,1,3,66.66666666666666,0.0,33.33333333333333
bitfence,0,0,0,0,0.0,0.0,0.0
maximine,0,0,0,0,0.0,0.0,0.0
biotron,4,0,7,11,36.36363636363637,0.0,63.63636363636363
berith,0,0,0,0,0.0,0.0,0.0
moneda,1,0,11,12,8.333333333333332,0.0,91.66666666666666
cytecoin,0,0,2,2,0.0,0.0,100.0
bitlumens,1,0,4,5,20.0,0.0,80.0
union,45,0,70,115,39.130434782608695,0.0,60.86956521739131
bhom,4,0,2,6,66.66666666666666,0.0,33.33333333333333
potentiam,0,0,4,4,0.0,0.0,100.0
emrify,0,0,0,0,0.0,0.0,0.0
hai project,1,0,0,1,100.0,0.0,0.0
langnet,2,0,0,2,100.0,0.0,0.0
ambr,11,0,51,62,17.741935483870968,0.0,82.25806451612904
snovio,0,0,0,0,0.0,0.0,0.0
alvalor,1,0,0,1,100.0,0.0,0.0
triggmine,0,0,0,0,0.0,0.0,0.0
thorium,0,0,1,1,0.0,0.0,100.0
sport x,0,0,0,0,0.0,0.0,0.0
mos,1425,0,3737,5162,27.605579232855483,0.0,72.39442076714452
vrt world,0,0,0,0,0.0,0.0,0.0
dateme,0,0,7,7,0.0,0.0,100.0
helios protocol,0,0,0,0,0.0,0.0,0.0
gravity gzro,0,0,0,0,0.0,0.0,0.0
gosama,3,0,1,4,75.0,0.0,25.0
laneaxis,0,0,0,0,0.0,0.0,0.0
cryptto,2,0,5,7,28.57142857142857,0.0,71.42857142857143
sleecoin,0,0,0,0,0.0,0.0,0.0
nau,37,0,73,110,33.63636363636363,0.0,66.36363636363637
trigid,0,0,0,0,0.0,0.0,0.0
vechain,25,0,52,77,32.467532467532465,0.0,67.53246753246754
nwp solution,0,0,0,0,0.0,0.0,0.0
kinguin,0,0,0,0,0.0,0.0,0.0
goldiam,2,0,2,4,50.0,0.0,50.0
first trading ecosystem,0,0,0,0,0.0,0.0,0.0
cybereits,0,0,0,0,0.0,0.0,0.0
blocknubie,0,0,0,0,0.0,0.0,0.0
hold,555,0,1315,1870,29.67914438502674,0.0,70.32085561497327
bcharity,0,0,5,5,0.0,0.0,100.0
alax,14,0,33,47,29.78723404255319,0.0,70.2127659574468
blockchain hotels 2.0,0,0,0,0,0.0,0.0,0.0
crypto angel,1,0,1,2,50.0,0.0,50.0
flashmoni,3,0,2,5,60.0,0.0,40.0
blackfol.io,0,0,0,0,0.0,0.0,0.0
disciplina,1,0,4,5,20.0,0.0,80.0
birake,0,0,0,0,0.0,0.0,0.0
extracredit,0,0,0,0,0.0,0.0,0.0
howdoo,0,0,0,0,0.0,0.0,0.0
sancoj,0,0,0,0,0.0,0.0,0.0
smart unit,0,0,0,0,0.0,0.0,0.0
papyrus,0,0,5,5,0.0,0.0,100.0
weicrowd,0,0,0,0,0.0,0.0,0.0
talao,0,0,0,0,0.0,0.0,0.0
etheal,0,0,0,0,0.0,0.0,0.0
stasyq,0,0,0,0,0.0,0.0,0.0
btu protocol,0,0,1,1,0.0,0.0,100.0
pantos by bitpanda,0,0,0,0,0.0,0.0,0.0
safein,0,0,0,0,0.0,0.0,0.0
eniac network,0,0,0,0,0.0,0.0,0.0
fox trading,4,0,1,5,80.0,0.0,20.0
decibels,0,0,0,0,0.0,0.0,0.0
mf chain,0,0,0,0,0.0,0.0,0.0
cryptelo,0,0,1,1,0.0,0.0,100.0
cartel,1,0,44,45,2.2222222222222223,0.0,97.77777777777777
bobâs repair,0,0,0,0,0.0,0.0,0.0
measurable data token,0,0,0,0,0.0,0.0,0.0
blok,7,0,31,38,18.421052631578945,0.0,81.57894736842105
adsigma,0,0,0,0,0.0,0.0,0.0
payvx,0,0,0,0,0.0,0.0,0.0
instant assets tokens,0,0,0,0,0.0,0.0,0.0
algebraix,0,0,0,0,0.0,0.0,0.0
chimaera,0,0,0,0,0.0,0.0,0.0
essentia,79,0,222,301,26.245847176079735,0.0,73.75415282392026
pibble,2,0,6,8,25.0,0.0,75.0
echarge,2,0,10,12,16.666666666666664,0.0,83.33333333333334
flux,8,0,22,30,26.666666666666668,0.0,73.33333333333333
lapo,0,0,5,5,0.0,0.0,100.0
verime,0,0,0,0,0.0,0.0,0.0
crestonium,0,0,0,0,0.0,0.0,0.0
os university,0,0,0,0,0.0,0.0,0.0
friend unifying platform,0,0,0,0,0.0,0.0,0.0
photochain,0,0,0,0,0.0,0.0,0.0
aeternum,1,0,8,9,11.11111111111111,0.0,88.88888888888889
xmoneta,0,0,0,0,0.0,0.0,0.0
aphelion,0,0,0,0,0.0,0.0,0.0
koios,2,0,2,4,50.0,0.0,50.0
blockshipping,0,0,0,0,0.0,0.0,0.0
aida service,0,0,0,0,0.0,0.0,0.0
trifid,2,0,6,8,25.0,0.0,75.0
darcmatter,0,0,0,0,0.0,0.0,0.0
signals,5,0,19,24,20.833333333333336,0.0,79.16666666666666
oyster shell,0,0,0,0,0.0,0.0,0.0
cashbag,0,0,2,2,0.0,0.0,100.0
viola,12,0,131,143,8.391608391608392,0.0,91.6083916083916
cappasity,0,0,0,0,0.0,0.0,0.0
biograffi,0,0,0,0,0.0,0.0,0.0
gluon,0,0,18,18,0.0,0.0,100.0
fishcoin,0,0,1,1,0.0,0.0,100.0
bzlcoin,0,0,0,0,0.0,0.0,0.0
a2b taxi,0,0,0,0,0.0,0.0,0.0
monanex,2,0,2,4,50.0,0.0,50.0
gladius,0,0,0,0,0.0,0.0,0.0
elementh,0,0,0,0,0.0,0.0,0.0
callisto,0,0,1,1,0.0,0.0,100.0
cibus,1,0,8,9,11.11111111111111,0.0,88.88888888888889
connectjob,0,0,0,0,0.0,0.0,0.0
bitnautic,0,0,0,0,0.0,0.0,0.0
woter,0,0,0,0,0.0,0.0,0.0
ethearnal,4,0,3,7,57.14285714285714,0.0,42.857142857142854
bitcore,0,0,1,1,0.0,0.0,100.0
game loot network,0,0,0,0,0.0,0.0,0.0
mydfs,0,0,1,1,0.0,0.0,100.0
semux,1,0,6,7,14.285714285714285,0.0,85.71428571428571
storweey,0,0,1,1,0.0,0.0,100.0
war field,1,0,0,1,100.0,0.0,0.0
leonardian,0,0,1,1,0.0,0.0,100.0
cornucopia,1,0,0,1,100.0,0.0,0.0
tutellus,0,0,0,0,0.0,0.0,0.0
corl,0,0,3,3,0.0,0.0,100.0
prandex,0,0,3,3,0.0,0.0,100.0
dizcovery network,6,0,0,6,100.0,0.0,0.0
blockfollow,0,0,0,0,0.0,0.0,0.0
webrunes,0,0,0,0,0.0,0.0,0.0
invest in brokers,0,0,0,0,0.0,0.0,0.0
apollochain,3,0,4,7,42.857142857142854,0.0,57.14285714285714
urunit,0,0,0,0,0.0,0.0,0.0
allstocks,1,0,0,1,100.0,0.0,0.0
